state.x,area_name,all_poverty,m_poverty,f_poverty,FIPS,med_income,med_income_white,med_income_black,med_income_nat_am,med_income_asian,hispanic,m_with,m_without,f_with,f_without,all_with,all_without,county.x,incidence_rate,avg_ann_incidence,county.y,mortality_rate,avg_ann_deaths,recent_trend,popestimate2015,state.y,county,Mortality_Rate_num,Incidence_Rate_num
AK,"Aleutians East Borough, Alaska",553,334,219,02013,61518,72639,31250,54750,62679,51250,876,1317,566,540,1442,1857,"Aleutians East Borough, Alaska(6,10)",*,3 or fewer,"Aleutians East Borough, Alaska<sup>3</sup>",*,*,**,3341,2,13,NA,NA
AK,"Aleutians West Census Area, Alaska",499,273,226,02016,84306,97321,93750,48750,81250,77500,2470,769,1707,564,4177,1333,"Aleutians West Census Area, Alaska(6,10)",*,3 or fewer,"Aleutians West Census Area, Alaska<sup>3</sup>",*,*,**,5702,2,16,NA,NA
AK,"Anchorage Municipality, Alaska",23914,10698,13216,02020,78326,87235,50535,53935,63757,53926,120747,23245,122426,21393,243173,44638,"Anchorage Borough, Alaska(6,10)",61.5,131,"Anchorage Borough, Alaska",47.3,96,falling,298695,2,20,47.3,61.5
AK,"Bethel Census Area, Alaska",4364,2199,2165,02050,51012,92647,73661,41594,110625,160114,6396,2708,6627,1774,13023,4482,"Bethel Census Area, Alaska(6,10)",62.7,6,"Bethel Census Area, Alaska",58.3,5,**,17946,2,50,58.3,62.7
AK,"Bristol Bay Borough, Alaska",69,33,36,02060,79750,88000,NA,63333,NA,25625,419,124,349,67,768,191,"Bristol Bay Borough, Alaska(6,10)",*,3 or fewer,"Bristol Bay Borough, Alaska",*,*,**,892,2,60,NA,NA
AK,"Denali Borough, Alaska",254,139,115,02068,81544,81029,NA,47500,NA,NA,822,253,674,250,1496,503,"Denali, Alaska(6,10)",*,3 or fewer,"Denali, Alaska",*,*,**,1919,2,68,NA,NA
AK,"Dillingham Census Area, Alaska",894,446,448,02070,54173,81161,NA,42212,NA,86458,1678,900,1837,546,3515,1446,"Dillingham Census Area, Alaska(6,10)",*,3 or fewer,"Dillingham Census Area, Alaska<sup>3</sup>",*,*,**,4997,2,70,NA,NA
AK,"Fairbanks North Star Borough, Alaska",7752,3523,4229,02090,71068,74242,56353,48333,56339,55284,40605,6957,40210,5322,80815,12279,"Fairbanks North Star, Alaska(6,10)",58.1,36,"Fairbanks North Star, Alaska",54,31,stable,99631,2,90,54,58.1
AK,"Haines Borough, Alaska",135,74,61,02100,58750,67888,NA,45714,NA,NA,960,422,944,228,1904,650,"Haines Borough, Alaska(6,10)",*,3 or fewer,"Haines Borough, Alaska",*,*,**,2534,2,100,NA,NA
AK,"Juneau City and Borough, Alaska",2110,1145,965,02110,85746,90553,106964,57821,80893,76083,13739,2433,13582,2213,27321,4646,"Juneau Borough, Alaska(6,10)",35.1,9,"Juneau Borough, Alaska",34.4,8,falling,32756,2,110,34.4,35.1
AK,"Kenai Peninsula Borough, Alaska",5558,2596,2962,02122,63684,64663,122660,46458,58125,64148,22391,6435,21668,5433,44059,11868,"Kenai Peninsula Borough, Alaska(6,10)",64.9,39,"Kenai Peninsula Borough, Alaska",50.1,28,falling,58059,2,122,50.1,64.9
AK,"Ketchikan Gateway Borough, Alaska",1640,792,848,02130,64222,73313,NA,45536,45859,83250,5339,1428,5527,1082,10866,2510,"Ketchikan Gateway Borough, Alaska(6,10)",88.3,12,"Ketchikan Gateway Borough, Alaska",70.8,9,**,13709,2,130,70.8,88.3
AK,"Kodiak Island Borough, Alaska",1552,962,590,02150,70887,82857,26827,48179,56585,87000,4941,1920,4943,1479,9884,3399,"Kodiak Island Borough, Alaska(6,10)",74.7,7,"Kodiak Island Borough, Alaska",76.2,6,**,13889,2,150,76.2,74.7
AK,"Lake and Peninsula Borough, Alaska",247,119,128,02164,50781,72500,NA,38482,NA,NA,445,286,513,230,958,516,"Lake and Peninsula Borough, Alaska(6,10)",*,3 or fewer,"Lake and Peninsula Borough, Alaska<sup>3</sup>",*,*,**,1563,2,164,NA,NA
AK,"Matanuska-Susitna Borough, Alaska",9454,4346,5108,02170,72983,74141,55577,56724,53789,77367,39282,9314,37751,8084,77033,17398,"Matanuska-Susitna Borough, Alaska(6,10)",69.7,51,"Matanuska-Susitna Borough, Alaska",53.9,37,stable,101095,2,170,53.9,69.7
AK,"Nome Census Area, Alaska",2592,1399,1193,02180,48868,85455,NA,37277,78056,86607,3506,1605,3430,1114,6936,2719,"Nome Census Area, Alaska(6,10)",103.6,6,"Nome Census Area, Alaska",96.1,6,**,9846,2,180,96.1,103.6
AK,"North Slope Borough, Alaska",976,532,444,02185,72576,86250,107500,59554,126964,88563,4847,1248,2579,910,7426,2158,"North Slope Borough, Alaska(6,10)",153.4,6,"North Slope Borough, Alaska",124.9,5,**,9687,2,185,124.9,153.4
AK,"Northwest Arctic Borough, Alaska",1824,951,873,02188,63648,99444,NA,52227,69375,NA,2690,1455,2542,1021,5232,2476,"Northwest Arctic Borough, Alaska(6,10)",67.6,3,"Northwest Arctic Borough, Alaska",*,*,**,7752,2,188,NA,67.6
AK,"Sitka City and Borough, Alaska",798,424,374,02220,70376,81029,143125,40625,75000,58333,3635,841,3591,692,7226,1533,"Sitka Borough, Alaska(6,10)",44,4,"Sitka Borough, Alaska",39.6,3,**,8863,2,220,39.6,44
AK,"Southeast Fairbanks Census Area, Alaska",1011,507,504,02240,62670,71349,51563,20774,33750,78750,2889,853,2454,666,5343,1519,"Southeast Fairbanks Census Area, Alaska(6,10)",76.8,5,"Southeast Fairbanks Census Area, Alaska",*,*,**,6839,2,240,NA,76.8
AK,"Valdez-Cordova Census Area, Alaska",1029,598,431,02261,78810,82090,NA,45000,105417,NA,3670,1292,3566,884,7236,2176,"Valdez-Cordova Census Area, Alaska(6,10)",66.1,6,"Valdez-Cordova Census Area, Alaska",60.8,4,**,9362,2,261,60.8,66.1
AK,"Yakutat City and Borough, Alaska",35,25,10,02282,72500,76250,NA,45625,127188,NA,289,78,217,59,506,137,"Yakutat City and Borough, Alaska(6,10)",*,3 or fewer,"Yakutat City and Borough, Alaska<sup>3</sup>",*,*,**,613,2,282,NA,NA
AK,"Yukon-Koyukuk Census Area, Alaska",1252,666,586,02290,38491,63000,NA,29750,76250,NA,1795,1225,1692,907,3487,2132,"Yukon-Koyukuk Census Area, Alaska(6,10)",58.3,3,"Yukon-Koyukuk Census Area, Alaska",*,*,**,5533,2,290,NA,58.3
AL,"Autauga County, Alabama",7057,2983,4074,01001,51281,56854,32073,NA,2499,61296,23500,2781,25417,2727,48917,5508,"Autauga County, Alabama(6,10)",74.9,43,"Autauga County, Alabama",59.3,34,falling,55347,1,1,59.3,74.9
AL,"Baldwin County, Alabama",25798,12018,13780,01003,50254,52594,26967,92670,36250,42468,79768,13644,88015,11343,167783,24987,"Baldwin County, Alabama(6,10)",66.9,170,"Baldwin County, Alabama",48,121,falling,203709,1,3,48,66.9
AL,"Barbour County, Alabama",6421,2856,3565,01005,32964,45039,21171,NA,NA,27132,9578,2163,10750,1569,20328,3732,"Barbour County, Alabama(6,10)",74.6,25,"Barbour County, Alabama",61.3,20,stable,26489,1,5,61.3,74.6
AL,"Bibb County, Alabama",3488,1495,1993,01007,38678,42263,27793,NA,NA,43750,9342,1012,9421,995,18763,2007,"Bibb County, Alabama(6,10)",86.4,23,"Bibb County, Alabama",67.8,17,stable,22583,1,7,67.8,86.4
AL,"Blount County, Alabama",9552,4593,4959,01009,45813,46601,31507,61310,NA,35271,24629,3642,25922,3017,50551,6659,"Blount County, Alabama(6,10)",69.7,51,"Blount County, Alabama",59.9,43,falling,57673,1,9,59.9,69.7
AL,"Bullock County, Alabama",2486,981,1505,01011,31938,52930,24595,NA,NA,NA,4088,1066,4191,762,8279,1828,"Bullock County, Alabama(6,10)",65.8,9,"Bullock County, Alabama",29.7,4,stable,10696,1,11,29.7,65.8
AL,"Butler County, Alabama",5094,2073,3021,01013,32229,42922,23453,NA,90833,NA,8129,1223,9482,1236,17611,2459,"Butler County, Alabama(6,10)",58.3,17,"Butler County, Alabama",52.6,15,stable,20154,1,13,52.6,58.3
AL,"Calhoun County, Alabama",23325,9500,13825,01015,41703,46399,26071,48409,NA,30575,47992,7440,53518,6245,101510,13685,"Calhoun County, Alabama(6,10)",84.2,120,"Calhoun County, Alabama",59.9,86,falling,115620,1,15,59.9,84.2
AL,"Chambers County, Alabama",7273,3091,4182,01017,34177,42336,25442,NA,62417,NA,13928,2198,15131,2476,29059,4674,"Chambers County, Alabama(6,10)",75.4,34,"Chambers County, Alabama",63.1,29,stable,34123,1,17,63.1,75.4
AL,"Cherokee County, Alabama",4918,2421,2497,01019,36296,36679,32973,NA,11313,NA,11401,1404,11730,1137,23131,2541,"Cherokee County, Alabama(6,10)",82.4,32,"Cherokee County, Alabama",54,21,stable,25859,1,19,54,82.4
AL,"Chilton County, Alabama",8288,3871,4417,01021,41627,43395,35189,83564,22981,28939,18164,3252,18371,3712,36535,6964,"Chilton County, Alabama(6,10)",73.9,39,"Chilton County, Alabama",66,34,stable,43943,1,21,66,73.9
AL,"Choctaw County, Alabama",3093,1206,1887,01023,33536,45321,21661,NA,NA,NA,5384,934,6098,850,11482,1784,"Choctaw County, Alabama(6,10)",49.2,10,"Choctaw County, Alabama",43,9,stable,13170,1,23,43,49.2
AL,"Clarke County, Alabama",6107,2495,3612,01025,32011,41390,19650,NA,NA,2499,9881,1825,11159,1934,21040,3759,"Clarke County, Alabama(6,10)",69.5,23,"Clarke County, Alabama",43.9,15,falling,24675,1,25,43.9,69.5
AL,"Clay County, Alabama",2201,902,1299,01027,35327,37166,30343,12679,NA,24914,5518,1022,5839,886,11357,1908,"Clay County, Alabama(6,10)",83.3,16,"Clay County, Alabama",69.1,13,rising,13555,1,27,69.1,83.3
AL,"Cleburne County, Alabama",2508,1069,1439,01029,38056,38886,30335,NA,NA,17431,6234,1017,6582,1013,12816,2030,"Cleburne County, Alabama(6,10)",74.9,14,"Cleburne County, Alabama",59.7,12,rising,15018,1,29,59.7,74.9
AL,"Coffee County, Alabama",8581,3867,4714,01031,46729,51998,26605,46607,39063,32372,20688,2891,22567,2783,43255,5674,"Coffee County, Alabama(6,10)",71.5,43,"Coffee County, Alabama",55.1,33,falling,51211,1,31,55.1,71.5
AL,"Colbert County, Alabama",9406,4124,5282,01033,40576,44296,28778,NA,NA,30994,23057,3007,24955,3003,48012,6010,"Colbert County, Alabama(6,10)",75.9,57,"Colbert County, Alabama",61.2,46,falling,54354,1,33,61.2,75.9
AL,"Conecuh County, Alabama",4320,2011,2309,01035,24900,32746,17366,NA,NA,13365,4925,1217,5227,1449,10152,2666,"Conecuh County, Alabama(6,10)",73.5,14,"Conecuh County, Alabama",60.2,12,stable,12672,1,35,60.2,73.5
AL,"Coosa County, Alabama",2073,961,1112,01037,31212,42727,23473,NA,NA,NA,4474,866,4605,805,9079,1671,"Coosa County, Alabama(6,10)",82.6,14,"Coosa County, Alabama",68.9,11,stable,10724,1,37,68.9,82.6
AL,"Covington County, Alabama",7515,3263,4252,01039,36444,39636,21875,26389,33177,51131,15536,2520,16877,2437,32413,4957,"Covington County, Alabama(6,10)",83,44,"Covington County, Alabama",71.9,39,stable,37835,1,39,71.9,83
AL,"Crenshaw County, Alabama",2288,1068,1220,01041,36022,42771,21614,55227,NA,72868,5847,939,6229,748,12076,1687,"Crenshaw County, Alabama(6,10)",61.5,11,"Crenshaw County, Alabama",47.3,9,falling,13963,1,41,47.3,61.5
AL,"Cullman County, Alabama",14814,6760,8054,01043,38971,39378,33333,NA,NA,21888,33641,6024,34557,5978,68198,12002,"Cullman County, Alabama(6,10)",69.6,73,"Cullman County, Alabama",61.4,63,stable,82005,1,43,61.4,69.6
AL,"Dale County, Alabama",9306,4092,5214,01045,45028,49655,26807,43088,73636,25115,19228,3179,21602,3161,40830,6340,"Dale County, Alabama(6,10)",76.7,44,"Dale County, Alabama",63.6,37,stable,49565,1,45,63.6,76.7
AL,"Dallas County, Alabama",14580,5889,8691,01047,27306,51431,20462,NA,49583,NA,16398,2891,19599,2951,35997,5842,"Dallas County, Alabama(6,10)",76.2,39,"Dallas County, Alabama",65.3,33,stable,41131,1,47,65.3,76.2
AL,"DeKalb County, Alabama",13133,5783,7350,01049,38192,38909,27629,NA,65114,27912,28735,6363,29767,5509,58502,11872,"DeKalb County, Alabama(6,10)",60.8,51,"DeKalb County, Alabama",56.3,46,stable,71130,1,49,56.3,60.8
AL,"Elmore County, Alabama",10334,4413,5921,01051,53555,58246,34370,48563,49342,29038,31679,3669,36728,3425,68407,7094,"Elmore County, Alabama(6,10)",78.1,66,"Elmore County, Alabama",66.1,55,stable,81468,1,51,66.1,78.1
AL,"Escambia County, Alabama",8609,3695,4914,01053,32330,39557,21925,32321,NA,NA,14055,3261,14958,3333,29013,6594,"Escambia County, Alabama(6,10)",75.5,36,"Escambia County, Alabama",67,32,stable,37789,1,53,67,75.5
AL,"Etowah County, Alabama",20078,8854,11224,01055,39220,41841,24950,35387,120714,35795,42271,7457,46984,6023,89255,13480,"Etowah County, Alabama(6,10)",81.9,110,"Etowah County, Alabama",67.7,90,stable,103057,1,55,67.7,81.9
AL,"Fayette County, Alabama",3055,1449,1606,01057,34680,36892,17270,NA,NA,30625,7557,832,7568,751,15125,1583,"Fayette County, Alabama(6,10)",77.3,19,"Fayette County, Alabama",58.3,14,stable,16759,1,57,58.3,77.3
AL,"Franklin County, Alabama",7020,2598,4422,01059,35372,36562,27340,27529,NA,34308,12966,2200,13441,2767,26407,4967,"Franklin County, Alabama(6,10)",72.4,28,"Franklin County, Alabama",65.8,25,stable,31696,1,59,65.8,72.4
AL,"Geneva County, Alabama",6149,2689,3460,01061,36024,37725,24296,34063,NA,35023,10913,2091,11495,1977,22408,4068,"Geneva County, Alabama(6,10)",90.3,35,"Geneva County, Alabama",71.2,27,stable,26777,1,61,71.2,90.3
AL,"Greene County, Alabama",3479,1562,1917,01063,20541,45136,17731,NA,NA,NA,3304,777,4081,484,7385,1261,"Greene County, Alabama(6,10)",87.9,10,"Greene County, Alabama",34.5,5,stable,8479,1,63,34.5,87.9
AL,"Hale County, Alabama",4011,1638,2373,01065,32714,47035,25127,NA,NA,34055,6051,997,7096,854,13147,1851,"Hale County, Alabama(6,10)",71,14,"Hale County, Alabama",57.8,11,stable,15068,1,65,57.8,71
AL,"Henry County, Alabama",2657,1085,1572,01067,41997,50725,22207,NA,NA,41477,7002,1164,7934,926,14936,2090,"Henry County, Alabama(6,10)",66.5,17,"Henry County, Alabama",56.3,14,stable,17221,1,67,56.3,66.5
AL,"Houston County, Alabama",18746,7893,10853,01069,41571,48967,24982,35662,45000,34063,42001,6928,47530,6187,89531,13115,"Houston County, Alabama(6,10)",70.8,88,"Houston County, Alabama",56.1,69,falling,104173,1,69,56.1,70.8
AL,"Jackson County, Alabama",9415,4398,5017,01071,37745,38158,20238,48947,NA,21840,21752,4072,23118,3424,44870,7496,"Jackson County, Alabama(6,10)",80.9,58,"Jackson County, Alabama",64,46,stable,52419,1,71,64,80.9
AL,"Jefferson County, Alabama",121029,52750,68279,01073,45610,60497,31867,35396,55052,34768,266456,40710,307962,36469,574418,77179,"Jefferson County, Alabama(6,10)",65.1,482,"Jefferson County, Alabama",51.5,381,falling,660367,1,73,51.5,65.1
AL,"Lamar County, Alabama",3382,1302,2080,01075,35450,37267,19792,NA,NA,NA,5876,885,6248,980,12124,1865,"Lamar County, Alabama(6,10)",80.4,17,"Lamar County, Alabama",72.2,15,stable,13886,1,75,72.2,80.4
AL,"Lauderdale County, Alabama",16232,6772,9460,01077,43125,45208,25992,22697,59750,36034,38885,5228,42682,5167,81567,10395,"Lauderdale County, Alabama(6,10)",69.3,87,"Lauderdale County, Alabama",56.8,71,stable,92596,1,77,56.8,69.3
AL,"Lawrence County, Alabama",6225,2780,3445,01079,40003,40061,30417,50372,28472,28482,14223,2042,15306,1773,29529,3815,"Lawrence County, Alabama(6,10)",88.1,37,"Lawrence County, Alabama",70,29,stable,33115,1,79,70,88.1
AL,"Lee County, Alabama",34561,15869,18692,01081,44570,50270,29991,NA,52870,40330,64110,8577,69209,7141,133319,15718,"Lee County, Alabama(6,10)",59.4,71,"Lee County, Alabama",57.1,66,stable,156993,1,81,57.1,59.4
AL,"Limestone County, Alabama",12075,5206,6869,01083,49570,51636,38971,NA,NA,30285,35387,5442,38770,5206,74157,10648,"Limestone County, Alabama(6,10)",73.4,69,"Limestone County, Alabama",55.9,51,falling,91663,1,83,55.9,73.4
AL,"Lowndes County, Alabama",3035,1353,1682,01085,25876,56045,19510,NA,NA,NA,4122,883,5036,563,9158,1446,"Lowndes County, Alabama(6,10)",57.6,8,"Lowndes County, Alabama",44,6,stable,10458,1,85,44,57.6
AL,"Macon County, Alabama",4636,2060,2576,01087,30738,39335,28249,23750,NA,64271,7564,1437,9797,1011,17361,2448,"Macon County, Alabama(6,10)",57.9,15,"Macon County, Alabama",41.1,10,stable,19105,1,87,41.1,57.9
AL,"Madison County, Alabama",46436,21195,25241,01089,57993,66922,35950,49044,64365,43009,145531,20878,156037,19760,301568,40638,"Madison County, Alabama(6,10)",64.8,236,"Madison County, Alabama",50.4,179,falling,353089,1,89,50.4,64.8
AL,"Marengo County, Alabama",5244,2056,3188,01091,32042,54205,20262,NA,NA,NA,8133,1209,9532,1205,17665,2414,"Marengo County, Alabama(6,10)",61.6,17,"Marengo County, Alabama",51.9,15,falling,20028,1,91,51.9,61.6
AL,"Marion County, Alabama",5960,2805,3155,01093,32299,32698,27727,70972,36010,35757,12619,1902,13590,1618,26209,3520,"Marion County, Alabama(6,10)",74.2,33,"Marion County, Alabama",51.7,23,falling,30168,1,93,51.7,74.2
AL,"Marshall County, Alabama",18794,8426,10368,01095,38983,39540,25688,NA,93125,24069,37272,8805,40331,7023,77603,15828,"Marshall County, Alabama(6,10)",79.4,90,"Marshall County, Alabama",66.6,75,falling,94725,1,95,66.6,79.4
AL,"Mobile County, Alabama",77917,31927,45990,01097,43809,53398,28066,42353,48063,40875,163094,28997,185337,28790,348431,57787,"Mobile County, Alabama(6,10)",75.4,347,"Mobile County, Alabama",63.3,289,falling,415395,1,97,63.3,75.4
AL,"Monroe County, Alabama",6901,2912,3989,01099,27257,37849,17029,50536,NA,14554,8832,1717,9448,2005,18280,3722,"Monroe County, Alabama(6,10)",62.3,19,"Monroe County, Alabama",52.9,16,stable,21673,1,99,52.9,62.3
AL,"Montgomery County, Alabama",49918,21699,28219,01101,44369,61342,34180,61684,72083,39923,88803,15281,105296,13407,194099,28688,"Montgomery County, Alabama(6,10)",61,144,"Montgomery County, Alabama",49.9,117,falling,226519,1,101,49.9,61
AL,"Morgan County, Alabama",18936,7640,11296,01103,45751,48739,25944,101364,62917,34331,48705,9071,51963,8345,100668,17416,"Morgan County, Alabama(6,10)",80.4,116,"Morgan County, Alabama",60.5,88,stable,119565,1,103,60.5,80.4
AL,"Perry County, Alabama",3373,1510,1863,01105,24537,43906,19336,NA,NA,NA,3926,666,4539,757,8465,1423,"Perry County, Alabama(6,10)",83.1,11,"Perry County, Alabama",60.3,8,stable,9652,1,105,60.3,83.1
AL,"Pickens County, Alabama",4801,2116,2685,01107,30330,41392,18722,NA,NA,36833,8174,1403,8582,1095,16756,2498,"Pickens County, Alabama(6,10)",65.6,18,"Pickens County, Alabama",57.5,16,stable,20864,1,107,57.5,65.6
AL,"Pike County, Alabama",8158,3810,4348,01109,32825,44427,21852,47188,NA,30375,13996,1760,15437,1754,29433,3514,"Pike County, Alabama(6,10)",61.8,22,"Pike County, Alabama",47.2,16,stable,33046,1,109,47.2,61.8
AL,"Randolph County, Alabama",4511,2048,2463,01111,36924,40027,28219,NA,NA,NA,9324,1666,9877,1545,19201,3211,"Randolph County, Alabama(6,10)",75.5,24,"Randolph County, Alabama",58.5,18,stable,22696,1,111,58.5,75.5
AL,"Russell County, Alabama",12054,4782,7272,01113,37049,44182,30005,21734,NA,67639,22282,4430,24884,4777,47166,9207,"Russell County, Alabama(6,10)",78.7,47,"Russell County, Alabama",64,38,falling,59660,1,113,64,78.7
AL,"St. Clair County, Alabama",13417,6115,7302,01115,51859,53010,42069,NA,107875,48042,36930,4549,38204,4318,75134,8867,"St. Clair County, Alabama(6,10)",74.7,72,"St. Clair County, Alabama",65,61,falling,87074,1,115,65,74.7
AL,"Shelby County, Alabama",16693,7492,9201,01117,70187,72574,58780,61964,81713,40143,88004,9927,95944,7945,183948,17872,"Shelby County, Alabama(6,10)",57.1,108,"Shelby County, Alabama",47.3,88,stable,208713,1,117,47.3,57.1
AL,"Sumter County, Alabama",5372,2187,3185,01119,19501,48636,15730,NA,70000,NA,4522,1343,6152,1187,10674,2530,"Sumter County, Alabama(6,10)",55.5,9,"Sumter County, Alabama",51,9,stable,13103,1,119,51,55.5
AL,"Talladega County, Alabama",17950,7613,10337,01121,35155,40996,24692,28681,129936,33661,32170,5151,36501,4860,68671,10011,"Talladega County, Alabama(6,10)",74,74,"Talladega County, Alabama",61,61,stable,80862,1,121,61,74
AL,"Tallapoosa County, Alabama",9117,3646,5471,01123,39206,47741,23739,11216,NA,27911,16879,2385,18924,2428,35803,4813,"Tallapoosa County, Alabama(6,10)",70.5,41,"Tallapoosa County, Alabama",54.5,32,falling,40844,1,123,54.5,70.5
AL,"Tuscaloosa County, Alabama",36274,15124,21150,01125,46565,55568,31879,37361,42649,39005,85157,10782,93413,9656,178570,20438,"Tuscaloosa County, Alabama(6,10)",72.3,135,"Tuscaloosa County, Alabama",54.4,100,falling,203976,1,125,54.4,72.3
AL,"Walker County, Alabama",14598,6480,8118,01127,35843,36618,24898,NA,NA,30725,26799,4750,29620,4050,56419,8800,"Walker County, Alabama(6,10)",98.3,89,"Walker County, Alabama",79.8,71,stable,65294,1,127,79.8,98.3
AL,"Washington County, Alabama",3200,1367,1833,01129,42811,44052,32361,53409,NA,39583,7140,1263,7114,1352,14254,2615,"Washington County, Alabama(6,10)",74.8,16,"Washington County, Alabama",65.3,14,stable,16804,1,129,65.3,74.8
AL,"Wilcox County, Alabama",4126,1910,2216,01131,23750,43516,18154,NA,NA,NA,4326,879,4850,921,9176,1800,"Wilcox County, Alabama(6,10)",73.2,11,"Wilcox County, Alabama",61.7,9,stable,11059,1,131,61.7,73.2
AL,"Winston County, Alabama",5157,2035,3122,01133,33194,33770,NA,22857,NA,28205,10251,1462,10390,1726,20641,3188,"Winston County, Alabama(6,10)",90.8,31,"Winston County, Alabama",69.9,24,stable,23877,1,133,69.9,90.8
AR,"Arkansas County, Arkansas",3705,1514,2191,05001,36411,42928,26242,NA,NA,27125,7568,1273,8583,1068,16151,2341,"Arkansas County, Arkansas(6,10)",85.9,21,"Arkansas County, Arkansas",67.8,17,stable,18433,5,1,67.8,85.9
AR,"Ashley County, Arkansas",4352,1961,2391,05003,34263,41506,18810,NA,NA,31333,8544,1538,9494,1478,18038,3016,"Ashley County, Arkansas(6,10)",77,23,"Ashley County, Arkansas",58.6,17,falling,20838,5,3,58.6,77
AR,"Baxter County, Arkansas",6452,3062,3390,05005,35396,35458,NA,NA,NA,61667,17259,2372,18915,2026,36174,4398,"Baxter County, Arkansas(6,10)",85.6,71,"Baxter County, Arkansas",64.3,54,stable,41053,5,5,64.3,85.6
AR,"Benton County, Arkansas",28804,13213,15591,05007,56239,55511,56509,44457,81290,43154,100609,16255,105249,14411,205858,30666,"Benton County, Arkansas(6,10)",56.4,129,"Benton County, Arkansas",47,106,falling,249672,5,7,47,56.4
AR,"Boone County, Arkansas",6465,2751,3714,05009,39251,39736,NA,10170,69297,50404,15299,2602,16771,2130,32070,4732,"Boone County, Arkansas(6,10)",67.7,35,"Boone County, Arkansas",62.6,33,stable,37222,5,9,62.6,67.7
AR,"Bradley County, Arkansas",3218,1350,1868,05011,33701,42250,22500,NA,NA,26536,4534,989,4797,793,9331,1782,"Bradley County, Arkansas(6,10)",86.3,13,"Bradley County, Arkansas",68.3,11,stable,11094,5,11,68.3,86.3
AR,"Calhoun County, Arkansas",907,409,498,05013,36899,43032,27891,NA,NA,34750,2227,411,2228,320,4455,731,"Calhoun County, Arkansas(6,10)",82.5,6,"Calhoun County, Arkansas",70.2,5,stable,5229,5,13,70.2,82.5
AR,"Carroll County, Arkansas",5001,2173,2828,05015,36897,37029,NA,NA,NA,35075,11137,2296,11452,2537,22589,4833,"Carroll County, Arkansas(6,10)",59.1,25,"Carroll County, Arkansas",47.7,20,stable,27704,5,15,47.7,59.1
AR,"Chicot County, Arkansas",3385,1350,2035,05017,28913,43224,20722,NA,NA,NA,4159,829,4935,763,9094,1592,"Chicot County, Arkansas(6,10)",76.4,12,"Chicot County, Arkansas",70.2,12,stable,11027,5,17,70.2,76.4
AR,"Clark County, Arkansas",4716,1872,2844,05019,35031,39805,22136,NA,45938,35278,9169,1412,10481,1349,19650,2761,"Clark County, Arkansas(6,10)",71.6,19,"Clark County, Arkansas",53.3,15,falling,22633,5,19,53.3,71.6
AR,"Clay County, Arkansas",3324,1472,1852,05021,32552,32251,NA,67143,NA,34779,6214,1308,6654,1090,12868,2398,"Clay County, Arkansas(6,10)",108.7,26,"Clay County, Arkansas",80.1,20,stable,15109,5,21,80.1,108.7
AR,"Cleburne County, Arkansas",3676,1696,1980,05023,42905,43417,NA,57794,NA,21563,10744,1960,10629,2018,21373,3978,"Cleburne County, Arkansas(6,10)",83.6,38,"Cleburne County, Arkansas",70.5,32,stable,25467,5,23,70.5,83.6
AR,"Cleveland County, Arkansas",1751,785,966,05025,43158,46296,21000,NA,NA,NA,3802,415,3698,517,7500,932,"Cleveland County, Arkansas(6,10)",77.5,9,"Cleveland County, Arkansas",67,7,stable,8311,5,25,67,77.5
AR,"Columbia County, Arkansas",5823,2540,3283,05027,36619,50998,20254,11518,NA,21835,9961,1427,10874,1642,20835,3069,"Columbia County, Arkansas(6,10)",72,21,"Columbia County, Arkansas",62.6,19,stable,24114,5,27,62.6,72
AR,"Conway County, Arkansas",4709,2344,2365,05029,37732,39860,30598,31875,NA,20431,8987,1322,9349,1275,18336,2597,"Conway County, Arkansas(6,10)",75,21,"Conway County, Arkansas",55.1,16,stable,21019,5,29,55.1,75
AR,"Craighead County, Arkansas",19715,8920,10795,05031,42475,45806,23202,25074,58452,27139,40807,8090,44480,7051,85287,15141,"Craighead County, Arkansas(6,10)",74.6,74,"Craighead County, Arkansas",49.2,48,falling,104354,5,31,49.2,74.6
AR,"Crawford County, Arkansas",11304,5456,5848,05033,41268,41283,26806,56176,40417,28695,25253,4761,27005,4175,52258,8936,"Crawford County, Arkansas(6,10)",79.1,56,"Crawford County, Arkansas",61.8,43,falling,61703,5,33,61.8,79.1
AR,"Crittenden County, Arkansas",11802,4745,7057,05035,38004,56377,25553,NA,62016,29967,19835,3330,22367,3672,42202,7002,"Crittenden County, Arkansas(6,10)",75.6,37,"Crittenden County, Arkansas",72.2,36,stable,48963,5,35,72.2,75.6
AR,"Cross County, Arkansas",3461,1459,2002,05037,38103,40965,21675,NA,58542,NA,6927,1358,7966,1005,14893,2363,"Cross County, Arkansas(6,10)",77.5,18,"Cross County, Arkansas",75.7,17,stable,17284,5,37,75.7,77.5
AR,"Dallas County, Arkansas",1141,521,620,05039,34084,41102,26775,NA,48304,NA,3076,490,3215,559,6291,1049,"Dallas County, Arkansas(6,10)",82.2,9,"Dallas County, Arkansas",74,9,stable,7604,5,39,74,82.2
AR,"Desha County, Arkansas",4029,1628,2401,05041,27197,42783,17373,NA,NA,21678,4813,911,5534,1048,10347,1959,"Desha County, Arkansas(6,10)",79.2,13,"Desha County, Arkansas",62.8,11,stable,11965,5,41,62.8,79.2
AR,"Drew County, Arkansas",5023,2381,2642,05043,32819,43676,17469,NA,NA,27736,7468,1560,8028,1292,15496,2852,"Drew County, Arkansas(6,10)",77.3,17,"Drew County, Arkansas",66.9,15,stable,18778,5,43,66.9,77.3
AR,"Faulkner County, Arkansas",17768,7625,10143,05045,51223,55041,29229,NA,48721,35547,50314,7392,53062,7289,103376,14681,"Faulkner County, Arkansas(6,10)",75.9,78,"Faulkner County, Arkansas",61.3,61,stable,121552,5,45,61.3,75.9
AR,"Franklin County, Arkansas",3854,1651,2203,05047,39285,39541,NA,35364,NA,13778,7539,1116,7827,1098,15366,2214,"Franklin County, Arkansas(6,10)",77.1,19,"Franklin County, Arkansas",70.1,17,stable,17702,5,47,70.1,77.1
AR,"Fulton County, Arkansas",2383,1094,1289,05049,37066,36749,NA,21250,NA,21250,5109,849,5326,756,10435,1605,"Fulton County, Arkansas(6,10)",64.7,14,"Fulton County, Arkansas",51.3,11,stable,12204,5,49,51.3,64.7
AR,"Garland County, Arkansas",19802,9205,10597,05051,38733,40935,21917,31300,NA,29423,37960,8263,42017,7421,79977,15684,"Garland County, Arkansas(6,10)",80.6,121,"Garland County, Arkansas",62.5,95,stable,97177,5,51,62.5,80.6
AR,"Grant County, Arkansas",2134,943,1191,05053,46171,46808,28711,23462,NA,19091,7806,1002,8160,929,15966,1931,"Grant County, Arkansas(6,10)",96.1,21,"Grant County, Arkansas",66.9,14,stable,18102,5,53,66.9,96.1
AR,"Greene County, Arkansas",7572,3161,4411,05055,41286,41224,NA,52578,NA,36301,18199,3041,18855,2801,37054,5842,"Greene County, Arkansas(6,10)",89.2,45,"Greene County, Arkansas",69.6,34,stable,44196,5,55,69.6,89.2
AR,"Hempstead County, Arkansas",5940,2685,3255,05057,32122,37732,24145,NA,NA,20965,8639,2045,9584,1824,18223,3869,"Hempstead County, Arkansas(6,10)",60.6,17,"Hempstead County, Arkansas",55.6,16,stable,22084,5,57,55.6,60.6
AR,"Hot Spring County, Arkansas",5975,2520,3455,05059,40000,42384,22794,NA,NA,35676,13038,2294,13930,2154,26968,4448,"Hot Spring County, Arkansas(6,10)",94.2,41,"Hot Spring County, Arkansas",75.3,32,stable,33426,5,59,75.3,94.2
AR,"Howard County, Arkansas",2910,1276,1634,05061,34229,40757,22636,NA,NA,34861,5307,1242,5610,1218,10917,2460,"Howard County, Arkansas(6,10)",96.2,16,"Howard County, Arkansas",83.1,14,stable,13300,5,61,83.1,96.2
AR,"Independence County, Arkansas",7783,3287,4496,05063,36265,36948,21810,2499,NA,30238,15227,2627,15939,2658,31166,5285,"Independence County, Arkansas(6,10)",82.3,38,"Independence County, Arkansas",59.3,27,falling,37052,5,63,59.3,82.3
AR,"Izard County, Arkansas",2663,1346,1317,05065,32630,32718,NA,NA,NA,71250,5407,912,5285,1083,10692,1995,"Izard County, Arkansas(6,10)",55.9,13,"Izard County, Arkansas",48.4,11,falling,13445,5,65,48.4,55.9
AR,"Jackson County, Arkansas",3819,1759,2060,05067,31261,32459,22179,NA,NA,NA,6560,1207,5615,903,12175,2110,"Jackson County, Arkansas(6,10)",104.4,24,"Jackson County, Arkansas",83.5,19,rising,17338,5,67,83.5,104.4
AR,"Jefferson County, Arkansas",17205,7764,9441,05069,36747,46712,29051,NA,57330,23281,28435,4044,32557,4219,60992,8263,"Jefferson County, Arkansas(6,10)",97.5,84,"Jefferson County, Arkansas",67.3,58,falling,71565,5,69,67.3,97.5
AR,"Johnson County, Arkansas",5574,2492,3082,05071,34139,35176,12500,33333,32917,30070,10777,1961,11377,1613,22154,3574,"Johnson County, Arkansas(6,10)",97.2,29,"Johnson County, Arkansas",67.9,20,stable,26141,5,71,67.9,97.2
AR,"Lafayette County, Arkansas",1731,692,1039,05073,31194,41726,18917,NA,NA,NA,2809,635,3106,588,5915,1223,"Lafayette County, Arkansas(6,10)",98.1,12,"Lafayette County, Arkansas",76.8,9,stable,6996,5,73,76.8,98.1
AR,"Lawrence County, Arkansas",3899,1796,2103,05075,32379,32373,NA,60469,NA,NA,6805,1419,7182,1309,13987,2728,"Lawrence County, Arkansas(6,10)",102.7,25,"Lawrence County, Arkansas",82.3,20,stable,16779,5,75,82.3,102.7
AR,"Lee County, Arkansas",2304,969,1335,05077,28393,38894,19779,NA,NA,NA,3231,875,3863,488,7094,1363,"Lee County, Arkansas(6,10)",57,8,"Lee County, Arkansas",61.9,8,stable,9650,5,77,61.9,57
AR,"Lincoln County, Arkansas",2257,1003,1254,05079,32580,41220,20252,NA,NA,30550,3666,768,4639,745,8305,1513,"Lincoln County, Arkansas(6,10)",63.4,10,"Lincoln County, Arkansas",59,9,stable,13820,5,79,59,63.4
AR,"Little River County, Arkansas",2402,1074,1328,05081,36205,39588,24578,110625,NA,NA,5288,1050,5384,837,10672,1887,"Little River County, Arkansas(6,10)",79.5,14,"Little River County, Arkansas",56.6,11,falling,12472,5,81,56.6,79.5
AR,"Logan County, Arkansas",4158,1995,2163,05083,35325,36390,25543,250001,34000,NA,9588,1364,9291,1510,18879,2874,"Logan County, Arkansas(6,10)",87,27,"Logan County, Arkansas",70.4,22,stable,21714,5,83,70.4,87
AR,"Lonoke County, Arkansas",8697,3814,4883,05085,53631,55487,25096,NA,65372,40500,29648,4044,31951,3462,61599,7506,"Lonoke County, Arkansas(6,10)",91.9,62,"Lonoke County, Arkansas",72.3,49,stable,71645,5,85,72.3,91.9
AR,"Madison County, Arkansas",3183,1329,1854,05087,37691,37747,NA,NA,NA,35128,6461,1384,6587,1199,13048,2583,"Madison County, Arkansas(6,10)",67.8,14,"Madison County, Arkansas",58.5,12,stable,15767,5,87,58.5,67.8
AR,"Marion County, Arkansas",3064,1345,1719,05089,34195,34137,NA,72431,NA,17788,6880,1224,7080,1120,13960,2344,"Marion County, Arkansas(6,10)",82.7,26,"Marion County, Arkansas",72.5,22,stable,16185,5,89,72.5,82.7
AR,"Miller County, Arkansas",8594,3519,5075,05091,40317,46144,27182,NA,NA,41029,17114,3465,18108,3769,35222,7234,"Miller County, Arkansas(6,10)",81.2,41,"Miller County, Arkansas",73.1,36,stable,43908,5,91,73.1,81.2
AR,"Mississippi County, Arkansas",11781,4964,6817,05093,34612,41279,25317,NA,31765,27438,17754,3431,19318,3527,37072,6958,"Mississippi County, Arkansas(6,10)",73.6,36,"Mississippi County, Arkansas",70.2,34,falling,43738,5,93,70.2,73.6
AR,"Monroe County, Arkansas",2501,1078,1423,05095,27647,36352,15625,NA,NA,NA,3037,567,3412,620,6449,1187,"Monroe County, Arkansas(6,10)",89.5,11,"Monroe County, Arkansas",70.9,9,stable,7399,5,95,70.9,89.5
AR,"Montgomery County, Arkansas",1620,728,892,05097,33037,33771,NA,80486,NA,63056,3605,881,3865,705,7470,1586,"Montgomery County, Arkansas(6,10)",67.5,11,"Montgomery County, Arkansas",50.4,8,stable,8970,5,97,50.4,67.5
AR,"Nevada County, Arkansas",2424,1176,1248,05099,30691,37540,24136,18173,NA,NA,3408,824,3731,631,7139,1455,"Nevada County, Arkansas(6,10)",69.2,9,"Nevada County, Arkansas",76.1,10,stable,8558,5,99,76.1,69.2
AR,"Newton County, Arkansas",1637,648,989,05101,34536,34583,NA,58281,NA,NA,3470,553,3379,594,6849,1147,"Newton County, Arkansas(6,10)",63.9,9,"Newton County, Arkansas",64.9,9,stable,7913,5,101,64.9,63.9
AR,"Ouachita County, Arkansas",5948,2211,3737,05103,31293,42348,21455,NA,NA,20208,10245,1311,11605,1487,21850,2798,"Ouachita County, Arkansas(6,10)",84,30,"Ouachita County, Arkansas",55.8,20,stable,24358,5,103,55.8,84
AR,"Perry County, Arkansas",1624,509,1115,05105,42346,43539,NA,NA,NA,NA,4607,478,4566,527,9173,1005,"Perry County, Arkansas(6,10)",98.8,14,"Perry County, Arkansas",78.5,11,stable,10189,5,105,78.5,98.8
AR,"Phillips County, Arkansas",6882,2991,3891,05107,26844,43491,20277,NA,NA,NA,7585,1824,9003,1794,16588,3618,"Phillips County, Arkansas(6,10)",88.1,23,"Phillips County, Arkansas",90.8,23,stable,19513,5,107,90.8,88.1
AR,"Pike County, Arkansas",2199,999,1200,05109,33097,33968,NA,NA,NA,19917,4360,993,4734,847,9094,1840,"Pike County, Arkansas(6,10)",87.8,13,"Pike County, Arkansas",63.5,10,stable,10824,5,109,63.5,87.8
AR,"Poinsett County, Arkansas",5416,2410,3006,05111,33070,35219,18276,26635,NA,22039,9578,2099,10369,1842,19947,3941,"Poinsett County, Arkansas(6,10)",114,36,"Poinsett County, Arkansas",103.5,33,stable,24040,5,111,103.5,114
AR,"Polk County, Arkansas",4878,2389,2489,05113,33702,34098,NA,NA,NA,29545,8138,1727,8596,1765,16734,3492,"Polk County, Arkansas(6,10)",67.1,22,"Polk County, Arkansas",57.8,18,stable,20216,5,113,57.8,67.1
AR,"Pope County, Arkansas",11818,5525,6293,05115,39810,40302,37102,35536,63233,32760,26407,4371,27067,4343,53474,8714,"Pope County, Arkansas(6,10)",86.3,59,"Pope County, Arkansas",72.5,49,stable,63390,5,115,72.5,86.3
AR,"Prairie County, Arkansas",1766,775,991,05117,35833,39059,23333,NA,NA,NA,3510,522,3650,570,7160,1092,"Prairie County, Arkansas(6,10)",89,12,"Prairie County, Arkansas",71.7,9,stable,8291,5,117,71.7,89
AR,"Pulaski County, Arkansas",67908,30871,37037,05119,46140,56369,31768,34158,62254,33789,155362,28215,177974,23280,333336,51495,"Pulaski County, Arkansas(6,10)",68,277,"Pulaski County, Arkansas",54.7,223,falling,392664,5,119,54.7,68
AR,"Randolph County, Arkansas",3651,1897,1754,05121,34044,34327,NA,NA,NA,13348,7056,1477,7688,1129,14744,2606,"Randolph County, Arkansas(6,10)",83.9,21,"Randolph County, Arkansas",69.9,18,stable,17469,5,121,69.9,83.9
AR,"St. Francis County, Arkansas",5857,2661,3196,05123,32105,36982,25924,NA,NA,20333,9159,2301,10761,1502,19920,3803,"St. Francis County, Arkansas(6,10)",65.2,20,"St. Francis County, Arkansas",54.4,16,stable,26589,5,123,54.4,65.2
AR,"Saline County, Arkansas",10176,4896,5280,05125,55817,57215,43631,28546,58375,51443,48403,6658,52131,5374,100534,12032,"Saline County, Arkansas(6,10)",73.9,100,"Saline County, Arkansas",52,69,falling,117460,5,125,52,73.9
AR,"Scott County, Arkansas",2165,1061,1104,05127,37321,37788,NA,NA,66250,34079,4655,872,4639,631,9294,1503,"Scott County, Arkansas(6,10)",91.5,15,"Scott County, Arkansas",63.5,10,stable,10513,5,127,63.5,91.5
AR,"Searcy County, Arkansas",1855,986,869,05129,33083,33300,NA,15682,NA,40313,3284,668,3306,618,6590,1286,"Searcy County, Arkansas(6,10)",72.1,10,"Searcy County, Arkansas",65.9,9,stable,7869,5,129,65.9,72.1
AR,"Sebastian County, Arkansas",28975,12570,16405,05131,38575,40849,21563,44592,42732,29090,52036,9869,54137,10109,106173,19978,"Sebastian County, Arkansas(6,10)",78.2,108,"Sebastian County, Arkansas",62.1,85,stable,127780,5,131,62.1,78.2
AR,"Sevier County, Arkansas",3755,1807,1948,05133,36579,38305,22824,NA,NA,29724,6695,1825,6927,1633,13622,3458,"Sevier County, Arkansas(6,10)",70.4,12,"Sevier County, Arkansas",60.4,10,stable,17290,5,133,60.4,70.4
AR,"Sharp County, Arkansas",3944,1700,2244,05135,30691,30665,NA,32188,243750,NA,6873,1357,7332,1315,14205,2672,"Sharp County, Arkansas(6,10)",89.3,26,"Sharp County, Arkansas",69.1,21,stable,16912,5,135,69.1,89.3
AR,"Stone County, Arkansas",3042,1414,1628,05137,29264,29322,NA,NA,NA,NA,5402,908,5237,859,10639,1767,"Stone County, Arkansas(6,10)",66.5,14,"Stone County, Arkansas",58.2,12,stable,12456,5,137,58.2,66.5
AR,"Union County, Arkansas",8172,3577,4595,05139,38678,48060,26845,33571,71339,30792,16488,2920,17939,2885,34427,5805,"Union County, Arkansas(6,10)",89,46,"Union County, Arkansas",71.6,38,stable,40144,5,139,71.6,89
AR,"Van Buren County, Arkansas",3574,1438,2136,05141,32312,32155,NA,NA,NA,36042,6656,1663,7101,1386,13757,3049,"Van Buren County, Arkansas(6,10)",65.1,19,"Van Buren County, Arkansas",57.5,17,stable,16771,5,141,57.5,65.1
AR,"Washington County, Arkansas",41846,19505,22341,05143,43524,46302,31528,27794,50938,36705,89087,18167,92453,14933,181540,33100,"Washington County, Arkansas(6,10)",67.1,119,"Washington County, Arkansas",52.7,91,falling,225477,5,143,52.7,67.1
AR,"White County, Arkansas",14175,6412,7763,05145,42554,43432,24738,NA,NA,23924,32331,6006,34463,5243,66794,11249,"White County, Arkansas(6,10)",91.2,81,"White County, Arkansas",69.6,61,falling,79161,5,145,69.6,91.2
AR,"Woodruff County, Arkansas",1612,740,872,05147,28993,31193,20863,NA,NA,NA,2662,686,2965,550,5627,1236,"Woodruff County, Arkansas(6,10)",108.5,11,"Woodruff County, Arkansas",64.9,7,stable,6741,5,147,64.9,108.5
AR,"Yell County, Arkansas",4009,1862,2147,05149,37804,38631,NA,90893,25671,36282,8865,1837,9456,1380,18321,3217,"Yell County, Arkansas(6,10)",88.1,24,"Yell County, Arkansas",76,21,stable,21713,5,149,76,88.1
AZ,"Apache County, Arizona",25852,12854,12998,04001,31757,42488,31761,25600,59632,34178,25743,9201,28542,7852,54285,17053,"Apache County, Arizona(6,10)",22.9,16,"Apache County, Arizona",17.7,12,stable,71474,4,1,17.7,22.9
AZ,"Cochise County, Arizona",21102,8595,12507,04003,45075,46090,66734,NA,61761,35446,47589,6771,55718,6614,103307,13385,"Cochise County, Arizona(6,10)",46.9,84,"Cochise County, Arizona",37,65,falling,126427,4,3,37,46.9
AZ,"Coconino County, Arizona",28824,13662,15162,04005,50234,55850,29613,37171,34792,46345,53505,13515,57656,11293,111161,24808,"Coconino County, Arizona(6,10)",36.7,39,"Coconino County, Arizona",25.6,26,stable,139097,4,5,25.6,36.7
AZ,"Gila County, Arizona",11839,5365,6474,04007,39751,40745,NA,26274,82847,40048,21863,4070,22671,3830,44534,7900,"Gila County, Arizona(6,10)",54.3,52,"Gila County, Arizona",43.8,42,falling,53159,4,7,43.8,54.3
AZ,"Graham County, Arizona",7446,3377,4069,04009,45964,47676,NA,27984,69010,46223,13834,2323,15164,2098,28998,4421,"Graham County, Arizona(6,10)",45.5,16,"Graham County, Arizona",33.8,12,falling,37666,4,9,33.8,45.5
AZ,"Greenlee County, Arizona",1215,538,677,04011,51628,48375,100682,90446,NA,46000,4139,584,3643,617,7782,1201,"Greenlee County, Arizona(6,10)",64,6,"Greenlee County, Arizona",41.8,4,**,9529,4,11,41.8,64
AZ,"La Paz County, Arizona",3824,1851,1973,04012,34466,35247,NA,30083,NA,36610,8733,1429,8625,1321,17358,2750,"La Paz County, Arizona(6,10)",54.4,25,"La Paz County, Arizona<sup>3</sup>",37.7,18,stable,20152,4,12,37.7,54.4
AZ,"Maricopa County, Arizona",673527,313707,359820,04013,54229,56337,39059,41137,70947,40294,1633881,332342,1747583,275016,3381464,607358,"Maricopa County, Arizona(6,10)",52.2,2059,"Maricopa County, Arizona",37.2,"1,463",falling,4167947,4,13,37.2,52.2
AZ,"Mohave County, Arizona",38874,18410,20464,04015,38488,38500,30859,36111,56756,32186,79661,16608,86521,14132,166182,30740,"Mohave County, Arizona(6,10)",76.6,280,"Mohave County, Arizona",59.1,216,falling,204737,4,15,59.1,76.6
AZ,"Navajo County, Arizona",32141,15025,17116,04017,35921,45641,NA,24805,42396,33107,41839,10188,44822,8626,86661,18814,"Navajo County, Arizona(6,10)",39.6,46,"Navajo County, Arizona",31,35,falling,108277,4,17,31,39.6
AZ,"Pima County, Arizona",187250,86251,100999,04019,46162,48801,36278,29877,45337,36745,404930,70973,444390,59712,849320,130685,"Pima County, Arizona(6,10)",50.9,628,"Pima County, Arizona",37.3,464,falling,1010025,4,19,37.3,50.9
AZ,"Pinal County, Arizona",63201,28120,35081,04021,49477,50501,52107,26310,66494,43213,155409,24692,163328,23603,318737,48295,"Pinal County, Arizona(6,10)",45.5,201,"Pinal County, Arizona",33.6,146,falling,406584,4,21,33.6,45.5
AZ,"Santa Cruz County, Arizona",10970,5162,5808,04023,40140,41819,101563,NA,73472,34613,18361,3991,20136,4339,38497,8330,"Santa Cruz County, Arizona(6,10)",36.1,19,"Santa Cruz County, Arizona",23.1,12,stable,46461,4,23,23.1,36.1
AZ,"Yavapai County, Arizona",34117,16249,17868,04025,44748,45086,50781,37228,71563,36870,90324,14466,95351,14369,185675,28835,"Yavapai County, Arizona(6,10)",51.9,203,"Yavapai County, Arizona",38.1,151,falling,222255,4,25,38.1,51.9
AZ,"Yuma County, Arizona",40508,18351,22157,04027,40743,41798,44348,26896,69716,35293,76032,20388,81132,17421,157164,37809,"Yuma County, Arizona(6,10)",48,115,"Yuma County, Arizona<sup>3</sup>",30.9,74,falling,204275,4,27,30.9,48
CA,"Alameda County, California",194639,87343,107296,06001,75619,82824,42093,52793,95216,57291,681621,88190,732996,70544,1414617,158734,"Alameda County, California(7,8)",46,687,"Alameda County, California",33.4,495,falling,1638215,6,1,33.4,46
CA,"Alpine County, California",195,106,89,06003,52917,59423,NA,35625,NA,NA,512,142,400,77,912,219,"Alpine County, California(7,9)",*,3 or fewer,"Alpine County, California",*,*,**,1110,6,3,NA,NA
CA,"Amador County, California",4191,1886,2305,06005,54171,54719,NA,37578,107995,31971,14369,1631,15820,1060,30189,2691,"Amador County, California(7,9)",58.7,38,"Amador County, California",47.2,31,falling,37001,6,5,47.2,58.7
CA,"Butte County, California",47532,23533,23999,06007,43444,44755,27031,40987,39435,35563,92483,16326,98566,12938,191049,29264,"Butte County, California(7,9)",61.4,169,"Butte County, California",46,126,falling,225411,6,7,46,61.4
CA,"Calaveras County, California",5590,2433,3157,06009,53233,55242,NA,NA,NA,54750,19250,2526,20634,1972,39884,4498,"Calaveras County, California(7,9)",52.3,41,"Calaveras County, California",40.2,31,falling,44828,6,9,40.2,52.3
CA,"Colusa County, California",3171,1590,1581,06011,52168,54123,NA,55208,NA,45092,8848,2183,8582,1592,17430,3775,"Colusa County, California(7,9)",56,11,"Colusa County, California",48.9,10,stable,21482,6,11,48.9,56
CA,"Contra Costa County, California",117915,52269,65646,06013,80185,85459,50343,56250,100536,58299,474034,57497,510094,48931,984128,106428,"Contra Costa County, California(7,8)",49.2,554,"Contra Costa County, California",36.1,404,falling,1126745,6,13,36.1,49.2
CA,"Del Norte County, California",5207,2385,2822,06015,40847,42245,9141,50689,NA,24340,10237,1462,11012,1310,21249,2772,"Del Norte County, California(7,9)",78.4,25,"Del Norte County, California",59.9,19,falling,27254,6,15,59.9,78.4
CA,"El Dorado County, California",18831,9082,9749,06017,69584,70097,98140,48958,116625,47863,81148,9011,83819,7027,164967,16038,"El Dorado County, California(7,9)",50,116,"El Dorado County, California",34.3,79,falling,184452,6,17,34.3,50
CA,"Fresno County, California",252187,117772,134415,06019,45233,50386,26110,36631,50683,36022,379453,88591,410573,66736,790026,155327,"Fresno County, California(7,9)",50.8,411,"Fresno County, California",36.2,291,falling,974861,6,19,36.2,50.8
CA,"Glenn County, California",5721,2544,3177,06021,39349,41957,26389,36483,19181,35973,11142,2797,11606,2187,22748,4984,"Glenn County, California(7,9)",61.2,19,"Glenn County, California",43.8,14,falling,28017,6,21,43.8,61.2
CA,"Humboldt County, California",28158,13202,14956,06023,42197,44095,28504,27097,32823,35800,54679,11986,56929,10368,111608,22354,"Humboldt County, California(7,9)",56.4,86,"Humboldt County, California",42.7,65,falling,135727,6,23,42.7,56.4
CA,"Imperial County, California",40114,18036,22078,06025,41079,42589,57321,36250,81128,37110,66068,14972,71962,14770,138030,29742,"Imperial County, California(7,9)",44.3,69,"Imperial County, California",27,42,falling,180191,6,25,27,44.3
CA,"Inyo County, California",2019,907,1112,06027,45955,46694,65625,37148,NA,45514,7794,1063,8106,971,15900,2034,"Inyo County, California(7,9)",45.7,13,"Inyo County, California",36.5,11,falling,18260,6,27,36.5,45.7
CA,"Kern County, California",195744,87585,108159,06029,49026,50315,32429,33876,71908,39686,344109,73189,358933,60514,703042,133703,"Kern County, California(7,9)",55.7,371,"Kern County, California",41.4,270,falling,882176,6,29,41.4,55.7
CA,"Kings County, California",29900,13392,16508,06031,46481,48190,40991,38816,63568,37384,53683,10579,57172,9062,110855,19641,"Kings County, California(7,9)",48.8,54,"Kings County, California",34.4,37,falling,150965,6,31,34.4,48.8
CA,"Lake County, California",15597,7932,7665,06033,35578,37724,24111,32750,42075,31597,25756,5905,27121,4688,52877,10593,"Lake County, California(7,9)",73.7,70,"Lake County, California",56,53,falling,64591,6,33,56,73.7
CA,"Lassen County, California",3563,1814,1749,06035,51555,51130,48500,61905,NA,46667,10144,1107,9576,1144,19720,2251,"Lassen County, California(7,9)",60.9,19,"Lassen County, California",51.3,15,stable,31345,6,35,51.3,60.9
CA,"Los Angeles County, California",1800265,823612,976653,06037,56196,62124,40665,46394,66356,45320,3904322,997326,4230137,837175,8134459,1834501,"Los Angeles County, California(7,9)",39.9,3701,"Los Angeles County, California",31.1,"2,876",falling,10170292,6,37,31.1,39.9
CA,"Madera County, California",33968,15721,18247,06039,45073,45095,35661,33516,53889,39124,57486,14771,62076,10344,119562,25115,"Madera County, California(7,9)",51.8,76,"Madera County, California",37,53,falling,154998,6,39,37,51.8
CA,"Marin County, California",20964,9707,11257,06041,93257,101129,54225,NA,89630,48813,111107,10737,123055,8224,234162,18961,"Marin County, California(7,8)",41.6,145,"Marin County, California",29.7,106,falling,261221,6,41,29.7,41.6
CA,"Mariposa County, California",2651,1264,1387,06043,47681,48529,NA,46111,NA,37976,7924,871,8092,729,16016,1600,"Mariposa County, California(7,9)",54.6,17,"Mariposa County, California",43.3,13,stable,17531,6,43,43.3,54.6
CA,"Mendocino County, California",17527,8215,9312,06045,42980,44531,19323,30598,49500,35090,35930,7213,38036,5443,73966,12656,"Mendocino County, California(7,9)",52.2,62,"Mendocino County, California",42.1,51,falling,87649,6,45,42.1,52.2
CA,"Merced County, California",67417,32269,35148,06047,42462,45504,32605,35347,50354,37404,106738,23878,112633,17643,219371,41521,"Merced County, California(7,9)",56.9,120,"Merced County, California",41.1,85,falling,268455,6,47,41.1,56.9
CA,"Modoc County, California",1673,833,840,06049,37860,38375,NA,35385,32813,26445,3678,797,3881,584,7559,1381,"Modoc County, California(7,9)",43.7,6,"Modoc County, California",34.8,5,stable,8965,6,49,34.8,43.7
CA,"Mono County, California",684,344,340,06051,56944,61066,NA,NA,86250,45076,5317,1929,5413,1413,10730,3342,"Mono County, California(7,9)",24.6,3,"Mono County, California",*,*,*,13909,6,51,NA,24.6
CA,"Monterey County, California",69475,31992,37483,06053,58783,59228,59634,58361,68208,48236,160439,42733,173038,33794,333477,76527,"Monterey County, California(7,9)",42.6,163,"Monterey County, California",31.7,121,falling,433898,6,53,31.7,42.6
CA,"Napa County, California",14020,6923,7097,06055,71379,72220,73003,50369,99486,52459,59832,8787,62340,7435,122172,16222,"Napa County, California(7,9)",53.3,92,"Napa County, California",40.6,70,falling,142456,6,55,40.6,53.3
CA,"Nevada County, California",12367,5582,6785,06057,56521,56538,NA,60134,71462,45869,41033,6956,43911,5718,84944,12674,"Nevada County, California(7,9)",47.3,75,"Nevada County, California",31.4,50,falling,98877,6,57,31.4,47.3
CA,"Orange County, California",395483,182267,213216,06059,76509,79914,66555,55123,80739,56510,1292176,237090,1361429,208099,2653605,445189,"Orange County, California(7,9)",44.1,1326,"Orange County, California",32.6,979,falling,3169776,6,59,32.6,44.1
CA,"Placer County, California",32427,15480,16947,06061,73948,73888,85580,60563,102714,54294,158349,18543,172630,13950,330979,32493,"Placer County, California(7,9)",49.6,222,"Placer County, California",34.3,154,falling,375391,6,61,34.3,49.6
CA,"Plumas County, California",2687,1168,1519,06063,47333,48809,NA,38377,23355,30918,8108,1407,8361,926,16469,2333,"Plumas County, California(7,9)",44.2,15,"Plumas County, California",36.5,12,falling,18409,6,63,36.5,44.2
CA,"Riverside County, California",379985,175705,204280,06065,56603,58994,52127,46960,71601,48510,916746,207979,974823,175978,1891569,383957,"Riverside County, California(7,9)",47.2,1031,"Riverside County, California",37.1,808,falling,2361026,6,65,37.1,47.2
CA,"Sacramento County, California",262251,122854,139397,06067,55987,60420,38792,48547,61374,45042,607503,96682,666343,79357,1273846,176039,"Sacramento County, California(7,9)",56.9,793,"Sacramento County, California",42.6,595,falling,1501335,6,67,42.6,56.9
CA,"San Benito County, California",6202,2722,3480,06069,71077,71115,75972,63750,92727,59295,24382,4284,25574,3155,49956,7439,"San Benito County, California(7,9)",40.2,18,"San Benito County, California",29.9,15,falling,58792,6,69,29.9,40.2
CA,"San Bernardino County, California",397766,178898,218868,06071,53433,55421,40705,41581,72134,49633,825890,177988,886691,159538,1712581,337526,"San Bernardino County, California(7,9)",49.5,807,"San Bernardino County, California",39,625,falling,2128133,6,71,39,49.5
CA,"San Diego County, California",454876,210952,243924,06073,64309,65480,50227,56297,81673,47896,1301142,234576,1380888,206949,2682030,441525,"San Diego County, California(7,9)",49,1485,"San Diego County, California",36,"1,097",falling,3299521,6,73,36,49
CA,"San Francisco County, California",109524,52571,56953,06075,81294,100091,29800,36198,69577,57948,384329,40788,380762,30288,765091,71076,"San Francisco County, California(7,8)",49,459,"San Francisco County, California",34.4,324,falling,864816,6,75,34.4,49
CA,"San Joaquin County, California",129390,59724,69666,06077,53274,56313,37428,37697,61128,44550,290726,55049,311300,42817,602026,97866,"San Joaquin County, California(7,9)",56.8,353,"San Joaquin County, California",44.8,277,falling,726106,6,77,44.8,56.8
CA,"San Luis Obispo County, California",38630,18816,19814,06079,60691,61694,63224,46250,59421,48178,117241,17433,120210,14696,237451,32129,"San Luis Obispo County, California(7,9)",46.9,161,"San Luis Obispo County, California",34.7,120,falling,281401,6,79,34.7,46.9
CA,"San Mateo County, California",59232,26750,32482,06081,93623,97207,56213,70792,107531,61383,330032,36082,349501,29233,679533,65315,"San Mateo County, California(7,8)",45.3,375,"San Mateo County, California",30.4,254,falling,765135,6,81,30.4,45.3
CA,"Santa Barbara County, California",68017,32772,35245,06083,63985,66814,51695,57699,68710,49516,175112,37490,186064,30108,361176,67598,"Santa Barbara County, California(7,9)",42.1,189,"Santa Barbara County, California",29.3,134,falling,444769,6,83,29.3,42.1
CA,"Santa Clara County, California",175690,81461,94229,06085,96310,94691,64219,55508,116152,61124,840137,93794,849441,75798,1689578,169592,"Santa Clara County, California(7,9)",41.1,705,"Santa Clara County, California",27.6,472,falling,1918044,6,85,27.6,41.1
CA,"Santa Cruz County, California",39053,17482,21571,06087,67256,69441,63977,32056,68528,48648,115040,17940,121172,13853,236212,31793,"Santa Cruz County, California(7,9)",37.6,99,"Santa Cruz County, California",28.4,74,falling,274146,6,87,28.4,37.6
CA,"Shasta County, California",31707,14584,17123,06089,44620,45180,39193,40240,45983,36457,73691,13334,79630,10912,153321,24246,"Shasta County, California(7,9)",62.5,154,"Shasta County, California",48.6,119,falling,179533,6,89,48.6,62.5
CA,"Sierra County, California",438,180,258,06091,42833,42396,NA,NA,NA,18194,1238,258,1387,108,2625,366,"Sierra County, California(7,9)",*,3 or fewer,"Sierra County, California",*,*,**,2967,6,91,NA,NA
CA,"Siskiyou County, California",10026,4814,5212,06093,37170,38610,17784,22230,39500,30472,18728,2957,19573,2444,38301,5401,"Siskiyou County, California(7,9)",60.5,44,"Siskiyou County, California",48,35,stable,43554,6,93,48,60.5
CA,"Solano County, California",55534,24891,30643,06095,66828,71497,50790,50324,83281,55834,175710,24415,193177,19391,368887,43806,"Solano County, California(7,9)",58.1,246,"Solano County, California",44.3,186,falling,436092,6,95,44.3,58.1
CA,"Sonoma County, California",57179,26643,30536,06097,64240,66800,60091,53208,69885,51334,208988,31276,224981,25613,433969,56889,"Sonoma County, California(7,9)",49.5,288,"Sonoma County, California",38.4,223,falling,502146,6,97,38.4,49.5
CA,"Stanislaus County, California",105927,48153,57774,06099,50125,51489,37772,37049,57620,42964,217812,41373,231370,33483,449182,74856,"Stanislaus County, California(7,9)",57.4,273,"Stanislaus County, California",42.1,200,falling,538388,6,99,42.1,57.4
CA,"Sutter County, California",16743,7675,9068,06101,52017,53549,57432,55156,51821,40639,38662,7984,41134,6258,79796,14242,"Sutter County, California(7,9)",56.3,56,"Sutter County, California",48,48,falling,96463,6,101,48,56.3
CA,"Tehama County, California",12313,5604,6709,06103,41001,40919,NA,38125,58109,43545,26592,4414,27736,3843,54328,8257,"Tehama County, California(7,9)",65.2,54,"Tehama County, California",49.9,40,falling,63308,6,103,49.9,65.2
CA,"Trinity County, California",2562,1226,1336,06105,34974,35474,NA,18205,NA,NA,5379,1332,5355,1094,10734,2426,"Trinity County, California(7,9)",66.6,15,"Trinity County, California",52.4,11,stable,13069,6,105,52.4,66.6
CA,"Tulare County, California",125775,60834,64941,06107,42031,42513,22458,36199,57851,34677,180176,44296,190135,35140,370311,79436,"Tulare County, California(7,9)",47.9,174,"Tulare County, California",40.7,145,falling,459863,6,107,40.7,47.9
CA,"Tuolumne County, California",7010,3092,3918,06109,50306,50883,30972,43182,52330,48225,22107,3017,23557,2159,45664,5176,"Tuolumne County, California(7,9)",58,52,"Tuolumne County, California",37.6,35,falling,53709,6,109,37.6,58
CA,"Ventura County, California",91880,42180,49700,06111,77348,76839,74474,59457,103602,59009,347674,63746,371628,51009,719302,114755,"Ventura County, California(7,9)",41.5,344,"Ventura County, California",30.3,250,falling,850536,6,111,30.3,41.5
CA,"Yolo County, California",39688,18185,21503,06113,54989,59421,36208,53810,46215,46885,87463,12481,95866,9946,183329,22427,"Yolo County, California(7,9)",42.3,74,"Yolo County, California",34.3,60,falling,213016,6,113,34.3,42.3
CA,"Yuba County, California",15862,7384,8478,06115,46892,48312,37386,31712,52528,41341,29943,5357,31024,4787,60967,10144,"Yuba County, California(7,9)",68.1,44,"Yuba County, California",55.3,35,falling,74492,6,115,55.3,68.1
CO,"Adams County, Colorado",64241,29134,35107,08001,58946,60451,43031,56750,58984,46978,189978,44652,197245,35868,387223,80520,"Adams County, Colorado(6,10)",52.6,182,"Adams County, Colorado",39,133,**,491337,8,1,39,52.6
CO,"Alamosa County, Colorado",4396,1771,2625,08003,32395,32353,24931,54000,NA,24268,6483,1147,7379,814,13862,1961,"Alamosa County, Colorado(6,10)",47.9,7,"Alamosa County, Colorado",30.5,5,stable,16496,8,3,30.5,47.9
CO,"Arapahoe County, Colorado",67679,31140,36539,08005,63265,68266,46143,44038,66821,44998,252809,43197,271608,35597,524417,78794,"Arapahoe County, Colorado(6,10)",47.5,253,"Arapahoe County, Colorado",33.7,177,falling,631096,8,5,33.7,47.5
CO,"Archuleta County, Colorado",1405,661,744,08007,46646,48588,NA,NA,NA,35361,4749,1386,4721,1212,9470,2598,"Archuleta County, Colorado(6,10)",31.7,6,"Archuleta County, Colorado",22.7,4,**,12352,8,7,22.7,31.7
CO,"Baca County, Colorado",736,308,428,08009,38000,38833,NA,NA,NA,32500,1438,301,1643,218,3081,519,"Baca County, Colorado(6,10)",78.2,5,"Baca County, Colorado",*,*,**,3615,8,9,NA,78.2
CO,"Bent County, Colorado",923,473,450,08011,36791,37982,NA,8929,NA,31154,1493,338,1601,192,3094,530,"Bent County, Colorado(6,10)",44,4,"Bent County, Colorado",*,*,**,5830,8,11,NA,44
CO,"Boulder County, Colorado",42167,20822,21345,08013,70961,72616,52284,38409,74525,42344,140104,14558,141062,12224,281166,26782,"Boulder County, Colorado(6,10)",35.5,94,"Boulder County, Colorado",24.3,65,**,319372,8,13,24.3,35.5
CO,"Broomfield County, Colorado",3930,1582,2348,08014,81898,82961,NA,NA,90586,62424,27449,2447,28789,1679,56238,4126,"Broomfield County, Colorado(6,10)",48.4,23,"Broomfield County, Colorado",37.8,18,**,65065,8,14,37.8,48.4
CO,"Chaffee County, Colorado",1502,647,855,08015,51092,50909,NA,NA,NA,33750,7356,1459,7403,1018,14759,2477,"Chaffee County, Colorado(6,10)",36.9,11,"Chaffee County, Colorado",30.6,8,stable,18658,8,15,30.6,36.9
CO,"Cheyenne County, Colorado",168,78,90,08017,52554,52609,NA,NA,NA,36806,811,220,747,179,1558,399,"Cheyenne County, Colorado(6,10)",*,3 or fewer,"Cheyenne County, Colorado",*,*,**,1829,8,17,NA,NA
CO,"Clear Creek County, Colorado",748,352,396,08019,67710,68680,28510,NA,NA,28173,4096,515,4092,306,8188,821,"Clear Creek County, Colorado(6,10)",38.1,3,"Clear Creek County, Colorado",*,*,**,9303,8,19,NA,38.1
CO,"Conejos County, Colorado",1491,735,756,08021,36652,36675,NA,NA,NA,30030,3320,750,3543,595,6863,1345,"Conejos County, Colorado(6,10)",34.7,4,"Conejos County, Colorado",32.6,3,**,8130,8,21,32.6,34.7
CO,"Costilla County, Colorado",850,354,496,08023,31321,31286,NA,13214,NA,24292,1581,285,1395,320,2976,605,"Costilla County, Colorado(6,10)",*,3 or fewer,"Costilla County, Colorado",*,*,**,3584,8,23,NA,NA
CO,"Crowley County, Colorado",1449,587,862,08025,31151,31389,NA,13750,53194,16989,1759,271,2125,266,3884,537,"Crowley County, Colorado(6,10)",*,3 or fewer,"Crowley County, Colorado",*,*,**,5562,8,25,NA,NA
CO,"Custer County, Colorado",736,385,351,08027,35000,35636,26833,NA,NA,NA,1613,524,1736,413,3349,937,"Custer County, Colorado(6,10)",59.5,4,"Custer County, Colorado",*,*,**,4445,8,27,NA,59.5
CO,"Delta County, Colorado",4716,2086,2630,08029,42452,42613,NA,33750,36743,35710,11449,2812,12536,2420,23985,5232,"Delta County, Colorado(6,10)",46.3,23,"Delta County, Colorado",35,17,falling,29979,8,29,35,46.3
CO,"Denver County, Colorado",110299,52215,58084,08031,53637,58585,33139,37257,51968,38740,267697,53725,282385,39310,550082,93035,"Denver County, Colorado(6,10)",48.5,264,"Denver County, Colorado",36.2,196,falling,682545,8,31,36.2,48.5
CO,"Dolores County, Colorado",398,218,180,08033,31875,32057,NA,NA,NA,36346,899,118,758,87,1657,205,"Dolores County, Colorado(6,10)",*,3 or fewer,"Dolores County, Colorado",*,*,**,1978,8,33,NA,NA
CO,"Douglas County, Colorado",12110,5653,6457,08035,102964,103212,109333,66442,103926,92710,143468,8170,147150,7231,290618,15401,"Douglas County, Colorado(6,10)",37.1,75,"Douglas County, Colorado",24,48,falling,322387,8,35,24,37.1
CO,"Eagle County, Colorado",4780,2769,2011,08037,72214,74237,53015,54637,51943,52067,22270,5524,20430,4256,42700,9780,"Eagle County, Colorado(6,10)",28.3,9,"Eagle County, Colorado",14.9,5,falling,53605,8,37,14.9,28.3
CO,"Elbert County, Colorado",1649,819,830,08039,84963,84336,105526,NA,NA,61451,10597,1313,10716,1135,21313,2448,"Elbert County, Colorado(6,10)",47.5,10,"Elbert County, Colorado",36.5,7,stable,24735,8,39,36.5,47.5
CO,"El Paso County, Colorado",75033,33973,41060,08041,58206,61208,47271,41645,60311,43176,266035,37593,290199,30351,556234,67944,"El Paso County, Colorado(6,10)",50.3,282,"El Paso County, Colorado",35.7,196,falling,674471,8,41,35.7,50.3
CO,"Fremont County, Colorado",6272,2828,3444,08043,40423,40451,NA,28478,NA,41794,14966,2281,16985,1946,31951,4227,"Fremont County, Colorado(6,10)",56.4,38,"Fremont County, Colorado",41.3,28,stable,46692,8,43,41.3,56.4
CO,"Garfield County, Colorado",6786,3452,3334,08045,56590,58930,34639,NA,33686,43764,20773,7848,21056,6668,41829,14516,"Garfield County, Colorado(6,10)",43.2,19,"Garfield County, Colorado",26.1,11,falling,58095,8,45,26.1,43.2
CO,"Gilpin County, Colorado",413,188,225,08047,65670,66210,NA,NA,NA,39643,2491,343,2426,292,4917,635,"Gilpin County, Colorado(6,10)",*,3 or fewer,"Gilpin County, Colorado",*,*,**,5828,8,47,NA,NA
CO,"Grand County, Colorado",1543,733,810,08049,63628,64840,37308,NA,NA,33506,6134,1509,5371,1336,11505,2845,"Grand County, Colorado(6,10)",47.5,6,"Grand County, Colorado",38.5,4,**,14615,8,49,38.5,47.5
CO,"Gunnison County, Colorado",2509,1163,1346,08051,48071,48628,NA,101563,NA,31454,6999,1402,6139,1059,13138,2461,"Gunnison County, Colorado(6,10)",24.8,3,"Gunnison County, Colorado",*,*,**,16067,8,51,NA,24.8
CO,"Hinsdale County, Colorado",70,34,36,08053,57083,57875,NA,NA,NA,NA,356,60,394,64,750,124,"Hinsdale County, Colorado(6,10)",*,3 or fewer,"Hinsdale County, Colorado",*,*,**,774,8,53,NA,NA
CO,"Huerfano County, Colorado",1171,646,525,08055,31715,32833,NA,43240,NA,25049,2602,584,2728,405,5330,989,"Huerfano County, Colorado(6,10)",59.2,8,"Huerfano County, Colorado",43.5,6,stable,6492,8,55,43.5,59.2
CO,"Jackson County, Colorado",155,71,84,08057,46014,46892,NA,NA,NA,38750,582,122,572,54,1154,176,"Jackson County, Colorado(6,10)",*,3 or fewer,"Jackson County, Colorado",*,*,**,1356,8,57,NA,NA
CO,"Jefferson County, Colorado",46423,20756,25667,08059,70164,70920,45554,68851,71856,51220,240890,28944,253891,22256,494781,51200,"Jefferson County, Colorado(6,10)",43.7,262,"Jefferson County, Colorado",30.5,179,**,565524,8,59,30.5,43.7
CO,"Kiowa County, Colorado",189,68,121,08061,40304,40439,NA,NA,NA,41563,544,115,676,99,1220,214,"Kiowa County, Colorado(6,10)",*,3 or fewer,"Kiowa County, Colorado",*,*,**,1423,8,61,NA,NA
CO,"Kit Carson County, Colorado",1157,444,713,08063,40603,41563,NA,NA,NA,22462,2923,574,3029,542,5952,1116,"Kit Carson County, Colorado(6,10)",55.1,6,"Kit Carson County, Colorado",36,4,stable,7758,8,63,36,55.1
CO,"Lake County, Colorado",833,373,460,08065,45367,49688,NA,NA,NA,41216,3236,742,2684,643,5920,1385,"Lake County, Colorado(6,10)",*,3 or fewer,"Lake County, Colorado",*,*,**,7485,8,65,NA,NA
CO,"La Plata County, Colorado",5432,2273,3159,08067,60278,61385,28922,49663,57344,52960,21982,4645,22642,3415,44624,8060,"La Plata County, Colorado(6,10)",34.4,19,"La Plata County, Colorado",24.6,13,falling,54688,8,67,24.6,34.4
CO,"Larimer County, Colorado",42338,19766,22572,08069,59805,60557,42036,36506,57875,46256,139780,17059,145434,13510,285214,30569,"Larimer County, Colorado(6,10)",39.7,124,"Larimer County, Colorado",29.8,92,falling,333577,8,69,29.8,39.7
CO,"Las Animas County, Colorado",2055,1039,1016,08071,45067,45376,45069,15568,39659,37436,5944,1071,6018,970,11962,2041,"Las Animas County, Colorado(6,10)",46.9,10,"Las Animas County, Colorado",37.3,8,stable,14058,8,71,37.3,46.9
CO,"Lincoln County, Colorado",624,223,401,08073,39005,39398,NA,25833,NA,31458,1416,115,2073,159,3489,274,"Lincoln County, Colorado(6,10)",53.5,4,"Lincoln County, Colorado",46.9,3,**,5557,8,73,46.9,53.5
CO,"Logan County, Colorado",3529,1745,1784,08075,42319,42475,2499,NA,NA,40699,9154,2218,8832,1110,17986,3328,"Logan County, Colorado(6,10)",36.4,10,"Logan County, Colorado",30.4,8,stable,22036,8,75,30.4,36.4
CO,"Mesa County, Colorado",22545,10438,12107,08077,49322,49658,39271,32689,NA,39535,62209,10578,64142,9629,126351,20207,"Mesa County, Colorado(6,10)",56.1,102,"Mesa County, Colorado",42.4,77,falling,148513,8,77,42.4,56.1
CO,"Mineral County, Colorado",56,18,38,08079,48125,52000,NA,NA,NA,45568,353,28,325,27,678,55,"Mineral County, Colorado(6,10)",*,3 or fewer,"Mineral County, Colorado",*,*,**,726,8,79,NA,NA
CO,"Moffat County, Colorado",1462,703,759,08081,51387,51829,NA,NA,64231,32129,5485,1268,5327,913,10812,2181,"Moffat County, Colorado(6,10)",40,6,"Moffat County, Colorado",37.3,5,**,12937,8,81,37.3,40
CO,"Montezuma County, Colorado",4550,2193,2357,08083,43553,44878,NA,28451,NA,40223,9654,2983,10467,2391,20121,5374,"Montezuma County, Colorado(6,10)",40.2,15,"Montezuma County, Colorado",31,12,falling,26168,8,83,31,40.2
CO,"Montrose County, Colorado",7644,3476,4168,08085,43999,44539,NA,NA,88523,34544,16045,3781,16771,3816,32816,7597,"Montrose County, Colorado(6,10)",49.6,28,"Montrose County, Colorado",40.3,24,stable,40946,8,85,40.3,49.6
CO,"Morgan County, Colorado",3218,1172,2046,08087,48450,48826,41228,30833,NA,46194,12045,1757,12343,1744,24388,3501,"Morgan County, Colorado(6,10)",49.5,16,"Morgan County, Colorado",41.2,13,stable,28360,8,87,41.2,49.5
CO,"Otero County, Colorado",4396,2097,2299,08089,32311,35986,NA,18904,30565,24850,7592,1415,8057,1311,15649,2726,"Otero County, Colorado(6,10)",40.5,11,"Otero County, Colorado",29.3,8,falling,18343,8,89,29.3,40.5
CO,"Ouray County, Colorado",355,174,181,08091,61624,61984,NA,NA,NA,31719,1844,395,2086,255,3930,650,"Ouray County, Colorado(6,10)",*,3 or fewer,"Ouray County, Colorado",*,*,**,4691,8,91,NA,NA
CO,"Park County, Colorado",1170,563,607,08093,56969,56462,NA,NA,NA,36176,7209,1208,6891,733,14100,1941,"Park County, Colorado(6,10)",35.8,8,"Park County, Colorado",25.5,4,stable,16510,8,93,25.5,35.8
CO,"Phillips County, Colorado",658,293,365,08095,43639,43417,NA,12750,NA,40109,1913,309,1816,268,3729,577,"Phillips County, Colorado(6,10)",53,4,"Phillips County, Colorado",*,*,**,4349,8,95,NA,53
CO,"Pitkin County, Colorado",1709,663,1046,08097,71196,71372,NA,86250,NA,35000,7865,1330,7024,1144,14889,2474,"Pitkin County, Colorado(6,10)",24.1,4,"Pitkin County, Colorado",*,*,**,17787,8,97,NA,24.1
CO,"Prowers County, Colorado",2264,993,1271,08099,40179,40260,NA,NA,NA,28214,5046,965,5307,732,10353,1697,"Prowers County, Colorado(6,10)",67.3,10,"Prowers County, Colorado",58.6,9,stable,11954,8,99,58.6,67.3
CO,"Pueblo County, Colorado",31017,14201,16816,08101,41286,43348,40104,34861,37931,34013,66883,10100,73703,6961,140586,17061,"Pueblo County, Colorado(6,10)",49.8,99,"Pueblo County, Colorado",36.8,74,falling,163591,8,101,36.8,49.8
CO,"Rio Blanco County, Colorado",1113,521,592,08103,61842,61118,NA,76136,NA,53750,3068,361,2880,309,5948,670,"Rio Blanco County, Colorado(6,10)",*,3 or fewer,"Rio Blanco County, Colorado",*,*,**,6571,8,103,NA,NA
CO,"Rio Grande County, Colorado",2198,1070,1128,08105,39672,38786,145610,NA,NA,35776,4698,960,4985,882,9683,1842,"Rio Grande County, Colorado(6,10)",29.2,5,"Rio Grande County, Colorado",21,3,**,11543,8,105,21,29.2
CO,"Routt County, Colorado",2369,1338,1031,08107,64963,66137,NA,NA,NA,55217,10917,1385,9954,1252,20871,2637,"Routt County, Colorado(6,10)",31.5,6,"Routt County, Colorado",24.3,4,falling,24130,8,107,24.3,31.5
CO,"Saguache County, Colorado",1450,609,841,08109,33393,34086,NA,25500,NA,31250,2162,937,2244,871,4406,1808,"Saguache County, Colorado(6,10)",60.6,4,"Saguache County, Colorado",*,*,**,6251,8,109,NA,60.6
CO,"San Juan County, Colorado",100,48,52,08111,36324,36379,NA,NA,NA,21250,264,63,226,53,490,116,"San Juan County, Colorado(6,10)",*,3 or fewer,"San Juan County, Colorado",*,*,**,701,8,111,NA,NA
CO,"San Miguel County, Colorado",854,398,456,08113,56047,55135,NA,NA,NA,48750,3475,562,3155,453,6630,1015,"San Miguel County, Colorado(6,10)",*,3 or fewer,"San Miguel County, Colorado",*,*,**,7879,8,113,NA,NA
CO,"Sedgwick County, Colorado",335,138,197,08115,44191,46350,70192,NA,41250,30938,964,164,1108,99,2072,263,"Sedgwick County, Colorado(6,10)",*,3 or fewer,"Sedgwick County, Colorado",*,*,**,2399,8,115,NA,NA
CO,"Summit County, Colorado",3949,1928,2021,08117,67983,71528,NA,33958,2499,41211,12116,3713,10374,2654,22490,6367,"Summit County, Colorado(6,10)",14.8,4,"Summit County, Colorado",21.6,3,**,30257,8,117,21.6,14.8
CO,"Teller County, Colorado",1728,826,902,08119,62372,62444,128750,NA,92708,42656,10383,1275,10200,1245,20583,2520,"Teller County, Colorado(6,10)",41.1,11,"Teller County, Colorado",26.4,8,falling,23385,8,119,26.4,41.1
CO,"Washington County, Colorado",466,184,282,08121,45541,45131,NA,NA,NA,34091,2001,259,2092,170,4093,429,"Washington County, Colorado(6,10)",*,3 or fewer,"Washington County, Colorado",*,*,**,4864,8,121,NA,NA
CO,"Weld County, Colorado",34007,15469,18538,08123,60572,62265,37281,47670,70000,43558,117241,16815,118408,15738,235649,32553,"Weld County, Colorado(6,10)",45.7,101,"Weld County, Colorado",35.2,76,**,285174,8,123,35.2,45.7
CO,"Yuma County, Colorado",1451,599,852,08125,43105,44702,NA,NA,NA,26250,4057,678,4550,756,8607,1434,"Yuma County, Colorado(6,10)",62.5,8,"Yuma County, Colorado",40.3,5,**,10146,8,125,40.3,62.5
CT,"Fairfield County, Connecticut",82743,36089,46654,09001,84233,94786,46418,43980,112109,47911,398180,55567,432919,44703,831099,100270,"Fairfield County, Connecticut(7,8)",54.9,571,"Fairfield County, Connecticut",34.5,365,falling,948053,9,1,34.5,54.9
CT,"Hartford County, Connecticut",104196,46770,57426,09003,66395,73333,42966,26289,86310,34131,390154,34444,430902,26115,821056,60559,"Hartford County, Connecticut(7,8)",62,662,"Hartford County, Connecticut",40.4,439,falling,895841,9,3,40.4,62
CT,"Litchfield County, Connecticut",12893,6253,6640,09005,72061,72584,64050,NA,73963,60701,84207,7090,88395,5185,172602,12275,"Litchfield County, Connecticut(7,8)",62.5,160,"Litchfield County, Connecticut",38.7,99,falling,183603,9,5,38.7,62.5
CT,"Middlesex County, Connecticut",10710,4712,5998,09007,79893,81748,50864,68274,105321,61407,74580,5483,79505,3690,154085,9173,"Middlesex County, Connecticut(7,8)",65.7,144,"Middlesex County, Connecticut",44.2,96,falling,164063,9,7,44.2,65.7
CT,"New Haven County, Connecticut",108533,46592,61941,09009,61640,68413,38667,41711,75756,36393,371693,38036,413529,28371,785222,66407,"New Haven County, Connecticut(7,8)",70.2,718,"New Haven County, Connecticut",44.9,467,falling,859470,9,9,44.9,70.2
CT,"New London County, Connecticut",25766,11243,14523,09011,66233,70299,45851,54753,69488,35648,117687,9625,127638,6301,245325,15926,"New London County, Connecticut(7,8)",68.7,224,"New London County, Connecticut",43.3,142,falling,271863,9,11,43.3,68.7
CT,"Tolland County, Connecticut",9511,4404,5107,09013,79626,80666,51968,NA,90176,48113,69525,4026,72384,2882,141909,6908,"Tolland County, Connecticut(7,8)",62.7,98,"Tolland County, Connecticut",41.8,65,falling,151420,9,13,41.8,62.7
CT,"Windham County, Connecticut",11999,4937,7062,09015,59392,60866,47056,55579,50938,31520,52591,4669,55081,3442,107672,8111,"Windham County, Connecticut(7,8)",65,86,"Windham County, Connecticut",47.5,62,falling,116573,9,15,47.5,65
DC,"District of Columbia, District of Columbia",110365,48069,62296,11001,70848,115890,40677,61985,83064,61087,276285,22198,323314,14813,599599,37011,"District of Columbia(6,10)",59,351,District of Columbia (State),40.6,240,falling,672228,11,1,40.6,59
DE,"Kent County, Delaware",22074,9294,12780,10001,54976,58299,48490,34177,48917,41556,71860,7217,81320,5658,153180,12875,"Kent County, Delaware(6,10)",79.2,147,"Kent County, Delaware",57,105,falling,173533,10,1,57,79.2
DE,"New Castle County, Delaware",60487,25747,34740,10003,65476,71263,49681,47074,94421,47696,236835,22972,262252,19167,499087,42139,"New Castle County, Delaware(6,10)",67.3,387,"New Castle County, Delaware",50.3,289,falling,556779,10,3,50.3,67.3
DE,"Sussex County, Delaware",25754,11078,14676,10005,53751,56665,36482,37411,97607,38682,87643,11295,96771,8798,184414,20093,"Sussex County, Delaware(6,10)",74.2,239,"Sussex County, Delaware",53.1,171,falling,215622,10,5,53.1,74.2
FL,"Alachua County, Florida",58203,27526,30677,12001,43073,50142,26561,31900,47236,32105,103064,18026,114762,15667,217826,33693,"Alachua County, Florida(6,10)",67.8,160,"Alachua County, Florida",48.6,114,falling,259964,12,1,48.6,67.8
FL,"Baker County, Florida",4393,1849,2544,12003,47121,51751,30553,NA,NA,100647,10298,1772,11081,1480,21379,3252,"Baker County, Florida(6,10)",99.5,27,"Baker County, Florida",75.2,21,stable,27420,12,3,75.2,99.5
FL,"Bay County, Florida",26235,11556,14679,12005,47368,49175,33759,27721,42727,42029,68041,15563,74296,13119,142337,28682,"Bay County, Florida(6,10)",88.4,185,"Bay County, Florida",66.5,139,falling,181635,12,5,66.5,88.4
FL,"Bradford County, Florida",4896,2208,2688,12007,41606,48213,23355,NA,NA,53889,9447,2538,10148,1770,19595,4308,"Bradford County, Florida(6,10)",82.1,28,"Bradford County, Florida",65.8,23,falling,26928,12,7,65.8,82.1
FL,"Brevard County, Florida",76460,35131,41329,12009,48925,50714,33027,54879,55728,42464,223646,43920,244237,36499,467883,80419,"Brevard County, Florida(6,10)",74.2,647,"Brevard County, Florida",55.4,487,falling,568088,12,9,55.4,74.2
FL,"Broward County, Florida",265880,119303,146577,12011,51968,56399,42020,41408,63451,51620,701051,186805,768123,176118,1469174,362923,"Broward County, Florida(6,10)",53.5,1129,"Broward County, Florida",38.7,827,falling,1896425,12,11,38.7,53.5
FL,"Calhoun County, Florida",2407,1034,1373,12013,34510,35000,30000,55139,61750,NA,4924,1212,5067,1382,9991,2594,"Calhoun County, Florida(6,10)",78.2,15,"Calhoun County, Florida",68.4,13,stable,14462,12,13,68.4,78.2
FL,"Charlotte County, Florida",19760,8772,10988,12015,44244,45107,32725,16429,48750,27344,65469,12778,72012,12279,137481,25057,"Charlotte County, Florida(6,10)",62.3,233,"Charlotte County, Florida",45.3,175,falling,173115,12,15,45.3,62.3
FL,"Citrus County, Florida",23903,10602,13301,12017,38312,38237,35171,34583,74141,33650,56990,9243,62626,8906,119616,18149,"Citrus County, Florida(6,10)",79.7,244,"Citrus County, Florida",64.2,200,falling,141058,12,17,64.2,79.7
FL,"Clay County, Florida",20580,9158,11422,12019,58290,59727,50825,55192,64081,58520,81814,12802,87934,11830,169748,24632,"Clay County, Florida(6,10)",79.2,161,"Clay County, Florida",58.5,117,falling,203967,12,19,58.5,79.2
FL,"Collier County, Florida",47436,22674,24762,12021,57452,59387,32252,47364,60750,40708,129514,37119,141173,31428,270687,68547,"Collier County, Florida(6,10)",43.3,268,"Collier County, Florida",30.5,194,falling,357305,12,21,30.5,43.3
FL,"Columbia County, Florida",12498,5458,7040,12023,41926,44156,29569,34375,93750,40239,25684,4960,27284,5238,52968,10198,"Columbia County, Florida(6,10)",88.2,77,"Columbia County, Florida",62.8,54,falling,68348,12,23,62.8,88.2
FL,"DeSoto County, Florida",10123,5668,4455,12027,35165,36579,22205,22188,NA,28697,12016,6079,12514,2527,24530,8606,"DeSoto County, Florida(6,10)",57.7,28,"DeSoto County, Florida",45,22,falling,35458,12,27,45,57.7
FL,"Dixie County, Florida",3061,1320,1741,12029,36292,36789,21667,NA,NA,NA,5773,1510,5975,1316,11748,2826,"Dixie County, Florida(6,10)",100,26,"Dixie County, Florida",73.8,19,stable,16203,12,29,73.8,100
FL,"Duval County, Florida",150792,66314,84478,12031,47690,54477,33145,45795,68057,41265,348726,69632,393413,61083,742139,130715,"Duval County, Florida(6,10)",78.1,685,"Duval County, Florida",53.8,465,falling,913010,12,31,53.8,78.1
FL,"Escambia County, Florida",45308,20987,24321,12033,45390,50794,30842,56161,40284,36743,116879,22448,132565,18328,249444,40776,"Escambia County, Florida(6,10)",78.4,281,"Escambia County, Florida",58.8,211,falling,311003,12,33,58.8,78.4
FL,"Flagler County, Florida",14814,6979,7835,12035,47866,49324,35800,NA,63291,47200,40356,7640,45070,7344,85426,14984,"Flagler County, Florida(6,10)",67.7,120,"Flagler County, Florida",49.7,90,stable,105392,12,35,49.7,67.7
FL,"Franklin County, Florida",1977,872,1105,12037,40401,40464,36917,27083,51917,51250,3898,1082,3899,903,7797,1985,"Franklin County, Florida(6,10)",93.4,16,"Franklin County, Florida",77.7,12,stable,11761,12,37,77.7,93.4
FL,"Gadsden County, Florida",11907,5937,5970,12039,35567,48910,29784,NA,32924,29792,16381,4465,19672,3451,36053,7916,"Gadsden County, Florida(6,10)",66.4,38,"Gadsden County, Florida",51.5,29,stable,46036,12,39,51.5,66.4
FL,"Gilchrist County, Florida",3598,1705,1893,12041,40623,40690,23750,23594,NA,NA,6212,1652,6150,1794,12362,3446,"Gilchrist County, Florida(6,10)",74.3,17,"Gilchrist County, Florida",71.7,17,stable,17199,12,41,71.7,74.3
FL,"Glades County, Florida",2408,1150,1258,12043,34877,34834,22841,85515,NA,36563,4492,1533,4683,1214,9175,2747,"Glades County, Florida(6,10)",54.9,13,"Glades County, Florida",41.5,9,falling,13670,12,43,41.5,54.9
FL,"Gulf County, Florida",1924,830,1094,12045,41788,44034,31556,NA,NA,29773,5660,1346,5374,1079,11034,2425,"Gulf County, Florida(6,10)",92.6,20,"Gulf County, Florida",65.2,14,falling,15871,12,45,65.2,92.6
FL,"Hamilton County, Florida",3234,1467,1767,12047,35048,40971,20941,NA,NA,17292,4472,903,4844,828,9316,1731,"Hamilton County, Florida(6,10)",67.8,12,"Hamilton County, Florida",53.2,9,falling,14295,12,47,53.2,67.8
FL,"Hardee County, Florida",7029,3262,3767,12049,35457,37104,26900,NA,NA,30239,9773,3558,9673,2790,19446,6348,"Hardee County, Florida(6,10)",69,20,"Hardee County, Florida",49.1,14,stable,27502,12,49,49.1,69
FL,"Hendry County, Florida",9696,4898,4798,12051,36771,40931,22298,27625,46042,34684,12624,6343,12932,4928,25556,11271,"Hendry County, Florida(6,10)",65.2,25,"Hendry County, Florida",47.8,18,falling,39119,12,51,47.8,65.2
FL,"Hernando County, Florida",27375,12662,14713,12053,40945,41559,26583,25139,44187,41056,69276,13919,77784,11982,147060,25901,"Hernando County, Florida(6,10)",74.9,241,"Hernando County, Florida",55.8,183,falling,178439,12,53,55.8,74.9
FL,"Highlands County, Florida",18863,9056,9807,12055,35093,36108,26045,8839,89583,26814,39100,8307,42730,7146,81830,15453,"Highlands County, Florida(6,10)",73.3,155,"Highlands County, Florida",51.4,110,stable,99491,12,55,51.4,73.3
FL,"Hillsborough County, Florida",217684,98476,119208,12057,50579,54914,34587,50721,71675,39548,513975,113535,566133,97187,1080108,210722,"Hillsborough County, Florida(6,10)",69.7,895,"Hillsborough County, Florida",48.3,616,falling,1349050,12,57,48.3,69.7
FL,"Holmes County, Florida",4903,2374,2529,12059,35020,35287,28750,NA,NA,10300,6781,1939,7454,1544,14235,3483,"Holmes County, Florida(6,10)",71.2,20,"Holmes County, Florida",68.6,18,stable,19324,12,59,68.6,71.2
FL,"Indian River County, Florida",20272,8950,11322,12061,45798,47439,26746,NA,86410,35382,55362,12465,62107,11598,117469,24063,"Indian River County, Florida(6,10)",67,180,"Indian River County, Florida",51.2,143,falling,147919,12,61,51.2,67
FL,"Jackson County, Florida",9090,4056,5034,12063,35098,38721,24740,31528,NA,26071,17614,2648,18268,2817,35882,5465,"Jackson County, Florida(6,10)",48.4,31,"Jackson County, Florida",52.8,34,falling,48599,12,63,52.8,48.4
FL,"Jefferson County, Florida",1862,741,1121,12065,43355,54559,23821,NA,NA,NA,4579,594,5855,714,10434,1308,"Jefferson County, Florida(6,10)",42.5,9,"Jefferson County, Florida",44.8,9,stable,14081,12,65,44.8,42.5
FL,"Lafayette County, Florida",1425,563,862,12067,35864,40250,31657,NA,NA,12071,2563,950,2877,624,5440,1574,"Lafayette County, Florida(6,10)",97.3,9,"Lafayette County, Florida",78.3,7,stable,8663,12,67,78.3,97.3
FL,"Lake County, Florida",42497,19644,22853,12069,46403,47413,38742,34604,77563,42081,125259,22303,138043,21490,263302,43793,"Lake County, Florida(6,10)",76,400,"Lake County, Florida",52.9,279,falling,325875,12,69,52.9,76
FL,"Lee County, Florida",105166,48604,56562,12071,48537,50195,34157,34750,47389,36948,255054,66636,280570,55914,535624,122550,"Lee County, Florida(6,10)",59.2,651,"Lee County, Florida",39.9,441,falling,701982,12,71,39.9,59.2
FL,"Leon County, Florida",60286,28018,32268,12073,46745,56324,31270,27386,52020,38282,115325,17626,131496,15063,246821,32689,"Leon County, Florida(6,10)",54.8,130,"Leon County, Florida",42,98,falling,286272,12,73,42,54.8
FL,"Levy County, Florida",8601,4159,4442,12075,35782,36778,30750,NA,14250,29163,15211,4276,16052,3841,31263,8117,"Levy County, Florida(6,10)",103.5,67,"Levy County, Florida",77.3,49,stable,39832,12,75,77.3,103.5
FL,"Liberty County, Florida",1237,711,526,12077,39406,42766,26205,NA,NA,38421,2740,935,2544,555,5284,1490,"Liberty County, Florida(6,10)",73.3,6,"Liberty County, Florida",84.1,7,stable,8331,12,77,84.1,73.3
FL,"Madison County, Florida",4269,1989,2280,12079,32164,38690,22361,NA,NA,60625,6335,1640,7137,1571,13472,3211,"Madison County, Florida(6,10)",54.8,14,"Madison County, Florida",55,14,stable,18408,12,79,55,54.8
FL,"Manatee County, Florida",51595,23144,28451,12081,49675,51590,35425,53750,61650,34849,133634,30738,149647,26970,283281,57708,"Manatee County, Florida(6,10)",59,328,"Manatee County, Florida",41.7,236,falling,363369,12,81,41.7,59
FL,"Marion County, Florida",60207,26829,33378,12083,39459,40756,30245,NA,52821,30966,128783,29261,144671,26132,273454,55393,"Marion County, Florida(6,10)",82,493,"Marion County, Florida",56.6,347,falling,343254,12,83,56.6,82
FL,"Martin County, Florida",17965,8725,9240,12085,51593,53535,30564,45200,69009,37871,60203,12641,67195,8716,127398,21357,"Martin County, Florida(6,10)",59.6,177,"Martin County, Florida",40.5,124,falling,156283,12,85,40.5,59.6
FL,"Miami-Dade County, Florida",530006,234079,295927,12086,43129,45586,33103,42237,61134,40499,913720,345984,1029301,323198,1943021,669182,"Miami-Dade County, Florida(6,10)",44.4,1310,"Miami-Dade County, Florida",29.9,885,falling,2693117,12,86,29.9,44.4
FL,"Monroe County, Florida",9998,4952,5046,12087,57290,59105,46275,NA,75192,43500,29681,9093,27902,7520,57583,16613,"Monroe County, Florida(6,10)",54.6,62,"Monroe County, Florida",45.5,50,falling,77482,12,87,45.5,54.6
FL,"Nassau County, Florida",9652,4524,5128,12089,54116,55071,33250,NA,64871,53914,30711,6234,33052,5141,63763,11375,"Nassau County, Florida(6,10)",81.2,83,"Nassau County, Florida",57.3,57,falling,78444,12,89,57.3,81.2
FL,"Okaloosa County, Florida",24595,11057,13538,12091,55880,58718,38208,62670,48704,46217,73497,13973,81113,12515,154610,26488,"Okaloosa County, Florida(6,10)",71.8,153,"Okaloosa County, Florida",57.1,121,falling,198664,12,91,57.1,71.8
FL,"Okeechobee County, Florida",9965,4747,5218,12093,35405,35678,28317,NA,51146,33452,13706,4583,14278,3667,27984,8250,"Okeechobee County, Florida(6,10)",93.3,48,"Okeechobee County, Florida",69.3,36,falling,39469,12,93,69.3,93.3
FL,"Orange County, Florida",212489,96829,115660,12095,47943,52068,36066,32356,57443,39062,467393,128157,507628,114016,975021,242173,"Orange County, Florida(6,10)",57.6,588,"Orange County, Florida",42.1,424,falling,1288126,12,95,42.1,57.6
FL,"Osceola County, Florida",58146,26746,31400,12097,44254,45851,39627,43355,52118,37150,112065,34689,121293,30788,233358,65477,"Osceola County, Florida(6,10)",54.7,147,"Osceola County, Florida",38.1,102,falling,323993,12,97,38.1,54.7
FL,"Palm Beach County, Florida",197340,88523,108817,12099,53363,56882,37601,45833,71473,42396,529441,128224,596926,111457,1126367,239681,"Palm Beach County, Florida(6,10)",54.1,1183,"Palm Beach County, Florida",37.3,852,falling,1422789,12,99,37.3,54.1
FL,"Pasco County, Florida",66144,29154,36990,12101,45064,44730,45550,38239,70052,46505,193843,35107,212253,32228,406096,67335,"Pasco County, Florida(6,10)",75.9,552,"Pasco County, Florida",57.3,422,falling,497909,12,101,57.3,75.9
FL,"Pinellas County, Florida",131643,58929,72714,12103,45819,47546,30695,43138,57230,36633,365646,75277,414317,64993,779963,140270,"Pinellas County, Florida(6,10)",68.9,1032,"Pinellas County, Florida",50.6,777,falling,949827,12,103,50.6,68.9
FL,"Polk County, Florida",111877,50847,61030,12105,43162,45438,31997,45735,62432,38347,244527,54900,269368,48305,513895,103205,"Polk County, Florida(6,10)",74.4,631,"Polk County, Florida",50.1,423,falling,650092,12,105,50.1,74.4
FL,"Putnam County, Florida",20397,9041,11356,12107,31715,34038,20512,21821,NA,28316,26738,8046,29921,6747,56659,14793,"Putnam County, Florida(6,10)",97.2,106,"Putnam County, Florida",71.1,78,stable,72023,12,107,71.1,97.2
FL,"St. Johns County, Florida",19706,8625,11081,12109,66194,67032,42171,76563,116250,50146,89166,11914,97157,10407,186323,22321,"St. Johns County, Florida(6,10)",65.2,166,"St. Johns County, Florida",42.3,107,falling,226640,12,109,42.3,65.2
FL,"St. Lucie County, Florida",52201,24225,27976,12111,43459,46015,30826,38885,64583,37262,111403,27579,121141,25709,232544,53288,"St. Lucie County, Florida(6,10)",64.5,277,"St. Lucie County, Florida",48.9,213,falling,298563,12,111,48.9,64.5
FL,"Santa Rosa County, Florida",19063,8482,10581,12113,58923,60549,46517,25278,62351,47892,63955,10401,68241,9510,132196,19911,"Santa Rosa County, Florida(6,10)",74.9,130,"Santa Rosa County, Florida",61.6,104,stable,167040,12,113,61.6,74.9
FL,"Sarasota County, Florida",42386,19475,22911,12115,51766,52680,31037,34410,58659,43207,156083,29291,177734,25125,333817,54416,"Sarasota County, Florida(6,10)",57.6,479,"Sarasota County, Florida",41.9,366,falling,405549,12,115,41.9,57.6
FL,"Seminole County, Florida",52637,24575,28062,12117,57010,60254,38754,46875,70719,42922,175304,34653,193878,30781,369182,65434,"Seminole County, Florida(6,10)",54.2,246,"Seminole County, Florida",41.5,187,falling,449144,12,117,41.5,54.2
FL,"Sumter County, Florida",10802,4602,6200,12119,50350,51247,23750,53350,NA,31006,42824,4040,47895,4641,90719,8681,"Sumter County, Florida(6,10)",65.3,180,"Sumter County, Florida",43.1,110,falling,118891,12,119,43.1,65.3
FL,"Suwannee County, Florida",10012,4500,5512,12121,36289,38041,23000,NA,NA,23333,16064,4338,18457,3256,34521,7594,"Suwannee County, Florida(6,10)",87.2,53,"Suwannee County, Florida",67.9,42,stable,43760,12,121,67.9,87.2
FL,"Taylor County, Florida",2720,1226,1494,12123,36181,38511,29341,17067,NA,41659,7353,1417,8621,1209,15974,2626,"Taylor County, Florida(6,10)",84.4,25,"Taylor County, Florida",66.8,20,falling,22493,12,123,66.8,84.4
FL,"Union County, Florida",2002,814,1188,12125,39163,40244,28516,86071,NA,NA,4013,645,4612,749,8625,1394,"Union County, Florida(6,10)",203.7,35,"Union County, Florida",113.5,19,falling,15234,12,125,113.5,203.7
FL,"Volusia County, Florida",85881,39086,46795,12127,41117,43139,25982,31767,50705,34411,195665,46346,218308,37655,413973,84001,"Volusia County, Florida(6,10)",70.8,568,"Volusia County, Florida",54.1,439,falling,517887,12,127,54.1,70.8
FL,"Wakulla County, Florida",4101,1658,2443,12129,50340,49726,55511,NA,NA,NA,11867,1904,12202,1544,24069,3448,"Wakulla County, Florida(6,10)",95.9,31,"Wakulla County, Florida",76.3,24,stable,31535,12,129,76.3,95.9
FL,"Walton County, Florida",9804,5087,4717,12131,44966,46422,27813,NA,66528,43370,22001,6235,24485,4684,46486,10919,"Walton County, Florida(6,10)",74.3,57,"Walton County, Florida",54.4,41,falling,63508,12,131,54.4,74.3
FL,"Washington County, Florida",4723,2407,2316,12133,38970,40368,28095,NA,NA,NA,9143,1767,9808,1333,18951,3100,"Washington County, Florida(6,10)",74.7,23,"Washington County, Florida",67.5,21,stable,24687,12,133,67.5,74.7
GA,"Appling County, Georgia",3745,1485,2260,13001,37135,39981,26130,NA,NA,30907,6884,1813,7352,1904,14236,3717,"Appling County, Georgia(7,9)",74.4,15,"Appling County, Georgia",56.3,12,stable,18454,13,1,56.3,74.4
GA,"Atkinson County, Georgia",2370,1068,1302,13003,30933,34130,24598,NA,NA,24009,2825,1239,2946,1258,5771,2497,"Atkinson County, Georgia(7,9)",59.4,5,"Atkinson County, Georgia",75.8,6,stable,8398,13,3,75.8,59.4
GA,"Bacon County, Georgia",1919,850,1069,13005,37162,42561,20302,NA,34706,42802,4042,1127,4639,893,8681,2020,"Bacon County, Georgia(7,9)",87.5,11,"Bacon County, Georgia",66.5,8,stable,11299,13,5,66.5,87.5
GA,"Baker County, Georgia",752,287,465,13007,44297,51538,26806,NA,NA,NA,1242,337,1360,353,2602,690,"Baker County, Georgia(7,9)",72.9,3,"Baker County, Georgia",*,*,**,3180,13,7,NA,72.9
GA,"Baldwin County, Georgia",13201,5601,7600,13009,32460,39592,22906,NA,39524,NA,17553,3212,20229,2532,37782,5744,"Baldwin County, Georgia(7,9)",73.5,36,"Baldwin County, Georgia",47.3,23,stable,45459,13,9,47.3,73.5
GA,"Banks County, Georgia",3026,1497,1529,13011,41472,41609,34342,NA,36146,29375,7764,1546,7383,1626,15147,3172,"Banks County, Georgia(7,9)",65.2,13,"Banks County, Georgia",33.8,7,stable,18495,13,11,33.8,65.2
GA,"Barrow County, Georgia",10902,5099,5803,13013,52012,53176,38643,NA,69886,41034,29308,6640,29988,5862,59296,12502,"Barrow County, Georgia(7,9)",89.6,55,"Barrow County, Georgia",63.4,37,stable,75370,13,13,63.4,89.6
GA,"Bartow County, Georgia",15819,6659,9160,13015,48893,51065,37979,56190,56094,33259,40864,8691,42129,8803,82993,17494,"Bartow County, Georgia(7,9)",91.3,91,"Bartow County, Georgia",63.2,61,stable,102747,13,15,63.2,91.3
GA,"Ben Hill County, Georgia",6024,2511,3513,13017,29994,38830,18397,NA,NA,26005,6364,1800,7307,1686,13671,3486,"Ben Hill County, Georgia(7,9)",84,18,"Ben Hill County, Georgia",65.1,13,falling,17403,13,17,65.1,84
GA,"Berrien County, Georgia",4923,2088,2835,13019,31835,34538,26063,NA,NA,29643,6868,2398,7046,2399,13914,4797,"Berrien County, Georgia(7,9)",78.2,18,"Berrien County, Georgia",54.4,12,falling,18963,13,19,54.4,78.2
GA,"Bibb County, Georgia",40611,16798,23813,13021,36519,52978,25620,NA,62300,27026,57314,12905,68408,12534,125722,25439,"Bibb County, Georgia(7,9)",79.4,134,"Bibb County, Georgia",59.1,99,falling,153721,13,21,59.1,79.4
GA,"Bleckley County, Georgia",2616,1270,1346,13023,38991,46932,17738,NA,NA,NA,5107,829,5784,661,10891,1490,"Bleckley County, Georgia(7,9)",72.3,11,"Bleckley County, Georgia",60.1,9,falling,12243,13,23,60.1,72.3
GA,"Brantley County, Georgia",3812,1561,2251,13025,37206,37212,29861,NA,NA,NA,6714,2402,6844,2433,13558,4835,"Brantley County, Georgia(7,9)",87.8,18,"Brantley County, Georgia",74.1,15,stable,18455,13,25,74.1,87.8
GA,"Brooks County, Georgia",4265,1864,2401,13027,32663,41641,19521,NA,NA,16801,5831,1825,6442,1500,12273,3325,"Brooks County, Georgia(7,9)",76.9,16,"Brooks County, Georgia",51.1,11,stable,15658,13,27,51.1,76.9
GA,"Bryan County, Georgia",4487,1939,2548,13029,63327,64884,54306,NA,37857,60219,13252,2139,14659,2148,27911,4287,"Bryan County, Georgia(7,9)",84.3,22,"Bryan County, Georgia",68.1,17,stable,35137,13,29,68.1,84.3
GA,"Bulloch County, Georgia",21794,10148,11646,13031,36032,41190,25995,NA,48967,28125,29523,5724,30317,5977,59840,11701,"Bulloch County, Georgia(7,9)",78.6,44,"Bulloch County, Georgia",56.8,32,stable,72651,13,31,56.8,78.6
GA,"Burke County, Georgia",7131,3099,4032,13033,33641,49398,19626,NA,48438,31736,8811,2074,9966,1911,18777,3985,"Burke County, Georgia(7,9)",85.9,21,"Burke County, Georgia",51.6,13,stable,22745,13,33,51.6,85.9
GA,"Butts County, Georgia",4329,2023,2306,13035,41667,50384,30746,NA,NA,124485,8376,1778,9064,1781,17440,3559,"Butts County, Georgia(7,9)",95.7,25,"Butts County, Georgia",81.3,20,rising,23593,13,35,81.3,95.7
GA,"Calhoun County, Georgia",1924,891,1033,13037,25513,40486,21366,NA,NA,NA,1590,514,2045,524,3635,1038,"Calhoun County, Georgia(7,9)",63.4,4,"Calhoun County, Georgia",50.2,4,stable,6479,13,37,50.2,63.4
GA,"Camden County, Georgia",6365,2795,3570,13039,52473,58940,38130,40250,87538,63529,19948,3210,21611,3033,41559,6243,"Camden County, Georgia(7,9)",67.4,29,"Camden County, Georgia",49.3,21,falling,52102,13,39,49.3,67.4
GA,"Candler County, Georgia",3398,1480,1918,13043,30185,34518,22307,NA,NA,NA,3697,1481,4227,1339,7924,2820,"Candler County, Georgia(7,9)",82.9,11,"Candler County, Georgia",62.1,8,stable,10886,13,43,62.1,82.9
GA,"Carroll County, Georgia",22441,9360,13081,13045,43586,46792,32268,NA,30882,27139,44101,9868,48004,9459,92105,19327,"Carroll County, Georgia(7,9)",83.9,88,"Carroll County, Georgia",59,62,stable,114545,13,45,59,83.9
GA,"Catoosa County, Georgia",8061,3588,4473,13047,50876,50819,49981,NA,55652,46985,26625,4978,29051,4201,55676,9179,"Catoosa County, Georgia(7,9)",65.6,50,"Catoosa County, Georgia",49.1,37,falling,66050,13,47,49.1,65.6
GA,"Charlton County, Georgia",2010,1140,870,13049,42778,41929,46875,NA,NA,46316,4584,1208,4690,1299,9274,2507,"Charlton County, Georgia(7,9)",60,9,"Charlton County, Georgia",49.4,7,stable,12965,13,49,49.4,60
GA,"Chatham County, Georgia",50980,21510,29470,13051,47218,55466,34807,NA,51606,41630,104174,23951,119106,24088,223280,48039,"Chatham County, Georgia(7,9)",65.2,183,"Chatham County, Georgia",44.4,126,falling,286956,13,51,44.4,65.2
GA,"Chattahoochee County, Georgia",960,569,391,13053,43378,44877,36895,NA,NA,39677,3063,521,3390,255,6453,776,"Chattahoochee County, Georgia(7,9)",84.3,3,"Chattahoochee County, Georgia",*,*,**,11368,13,53,NA,84.3
GA,"Chattooga County, Georgia",5488,2243,3245,13055,32913,33927,22219,NA,NA,38750,9063,2149,10018,2139,19081,4288,"Chattooga County, Georgia(7,9)",101.5,31,"Chattooga County, Georgia",74.5,23,stable,24922,13,55,74.5,101.5
GA,"Cherokee County, Georgia",24273,11323,12950,13057,68926,70839,67347,NA,61196,41363,93307,17236,99818,14680,193125,31916,"Cherokee County, Georgia(7,9)",73.2,135,"Cherokee County, Georgia",46.7,84,falling,235900,13,57,46.7,73.2
GA,"Clarke County, Georgia",40559,18801,21758,13059,32162,37856,24395,NA,33598,27375,46322,10381,53847,9368,100169,19749,"Clarke County, Georgia(7,9)",61.8,52,"Clarke County, Georgia",41.6,36,falling,123912,13,59,41.6,61.8
GA,"Clay County, Georgia",1285,579,706,13061,20438,41359,14797,NA,NA,NA,1022,463,1258,303,2280,766,"Clay County, Georgia(7,9)",64.1,3,"Clay County, Georgia",*,*,**,3141,13,61,NA,64.1
GA,"Clayton County, Georgia",65787,29093,36694,13063,40938,38499,41967,25700,41626,34582,91148,33348,106904,32596,198052,65944,"Clayton County, Georgia(7,8)",65.1,115,"Clayton County, Georgia",45.5,79,falling,273955,13,63,45.5,65.1
GA,"Clinch County, Georgia",2339,915,1424,13065,24015,36016,12905,NA,NA,2499,2631,644,2665,720,5296,1364,"Clinch County, Georgia(7,9)",86.9,7,"Clinch County, Georgia",56,4,stable,6893,13,65,56,86.9
GA,"Cobb County, Georgia",87880,40060,47820,13067,65873,75041,50341,34120,84976,42816,283287,61679,312433,56631,595720,118310,"Cobb County, Georgia(7,8)",60.3,341,"Cobb County, Georgia",40.3,223,falling,741334,13,67,40.3,60.3
GA,"Coffee County, Georgia",9975,4089,5886,13069,33965,37395,23251,35083,45466,26505,14017,4585,16269,4704,30286,9289,"Coffee County, Georgia(7,9)",79.5,34,"Coffee County, Georgia",59.9,25,stable,43108,13,69,59.9,79.5
GA,"Colquitt County, Georgia",12086,5622,6464,13071,32409,38286,22201,38482,NA,31474,15045,7292,17560,5434,32605,12726,"Colquitt County, Georgia(7,9)",89.5,44,"Colquitt County, Georgia",62,30,stable,45844,13,71,62,89.5
GA,"Columbia County, Georgia",12517,5247,7270,13073,71021,72414,62171,NA,87164,52962,57173,6985,62660,6391,119833,13376,"Columbia County, Georgia(7,9)",61.4,73,"Columbia County, Georgia",43.8,53,falling,144052,13,73,43.8,61.4
GA,"Cook County, Georgia",4244,1837,2407,13075,35683,41234,26307,38571,NA,30956,6130,2021,6425,2313,12555,4334,"Cook County, Georgia(7,9)",90,17,"Cook County, Georgia",60.5,12,stable,17124,13,75,60.5,90
GA,"Coweta County, Georgia",17489,7061,10428,13077,62461,66660,40190,250001,68958,38823,56787,8063,60351,7622,117138,15685,"Coweta County, Georgia(7,9)",65,78,"Coweta County, Georgia",47.4,57,falling,138427,13,77,47.4,65
GA,"Crawford County, Georgia",2122,984,1138,13079,41825,44298,28682,NA,NA,NA,5257,1072,5226,836,10483,1908,"Crawford County, Georgia(7,9)",100.7,16,"Crawford County, Georgia",65.9,9,rising,12388,13,79,65.9,100.7
GA,"Crisp County, Georgia",7468,3161,4307,13081,31615,47089,17637,NA,NA,52893,8719,1980,9882,2284,18601,4264,"Crisp County, Georgia(7,9)",72.3,21,"Crisp County, Georgia",59.2,17,stable,22881,13,81,59.2,72.3
GA,"Dade County, Georgia",2300,986,1314,13083,46434,47377,NA,NA,NA,NA,6555,1335,7142,1264,13697,2599,"Dade County, Georgia(7,9)",79.7,17,"Dade County, Georgia",79.3,16,stable,16264,13,83,79.3,79.7
GA,"Dawson County, Georgia",3156,1372,1784,13085,56943,57078,NA,NA,NA,42721,9301,1797,9935,1457,19236,3254,"Dawson County, Georgia(7,9)",74.1,21,"Dawson County, Georgia",61.8,16,stable,23312,13,85,61.8,74.1
GA,"Decatur County, Georgia",7418,3071,4347,13087,31284,38125,22021,55417,NA,50427,9471,2732,11253,2606,20724,5338,"Decatur County, Georgia(7,9)",70.4,23,"Decatur County, Georgia",58.2,19,stable,27174,13,87,58.2,70.4
GA,"DeKalb County, Georgia",135469,61067,74402,13089,51376,73219,42048,41875,53266,36789,266420,70503,307491,64529,573911,135032,"DeKalb County, Georgia(7,8)",53.2,311,"DeKalb County, Georgia",37.8,216,falling,734871,13,89,37.8,53.2
GA,"Dodge County, Georgia",4279,2065,2214,13091,34271,41636,26994,NA,NA,17806,7503,1809,8548,1351,16051,3160,"Dodge County, Georgia(7,9)",81.3,20,"Dodge County, Georgia",53.6,13,stable,20882,13,91,53.6,81.3
GA,"Dooly County, Georgia",3673,1729,1944,13093,28696,30847,22813,NA,NA,38223,4541,1544,5394,1140,9935,2684,"Dooly County, Georgia(7,9)",58.6,10,"Dooly County, Georgia",29.8,5,falling,14035,13,93,29.8,58.6
GA,"Dougherty County, Georgia",27557,11753,15804,13095,32084,50469,26399,NA,NA,34063,32319,9804,40211,9197,72530,19001,"Dougherty County, Georgia(7,9)",73.4,72,"Dougherty County, Georgia",60.9,59,rising,91332,13,95,60.9,73.4
GA,"Douglas County, Georgia",22118,9856,12262,13097,53881,56579,49904,33500,64697,47247,53134,11539,59541,11129,112675,22668,"Douglas County, Georgia(7,9)",81.1,90,"Douglas County, Georgia",55,59,falling,140733,13,97,55,81.1
GA,"Early County, Georgia",2916,1293,1623,13099,31680,44729,20277,NA,NA,2499,3871,934,4701,914,8572,1848,"Early County, Georgia(7,9)",61.5,9,"Early County, Georgia",60.1,8,stable,10575,13,99,60.1,61.5
GA,"Echols County, Georgia",1170,436,734,13101,32959,34337,NA,NA,NA,23459,1259,634,1488,667,2747,1301,"Echols County, Georgia(7,9)",*,3 or fewer,"Echols County, Georgia",*,*,**,4040,13,101,NA,NA
GA,"Effingham County, Georgia",5749,2473,3276,13103,63100,67761,40513,NA,82661,62769,22974,3773,22833,4476,45807,8249,"Effingham County, Georgia(7,9)",85.2,41,"Effingham County, Georgia",65.8,29,stable,57106,13,103,65.8,85.2
GA,"Elbert County, Georgia",3664,1459,2205,13105,35388,41173,20120,NA,NA,39097,7653,1521,8694,1435,16347,2956,"Elbert County, Georgia(7,9)",73.4,20,"Elbert County, Georgia",56,15,stable,19364,13,105,56,73.4
GA,"Emanuel County, Georgia",6700,3151,3549,13107,32229,38174,23941,NA,2499,37156,7750,2841,9203,2169,16953,5010,"Emanuel County, Georgia(7,9)",67.6,18,"Emanuel County, Georgia",59.3,16,stable,22708,13,107,59.3,67.6
GA,"Evans County, Georgia",2857,1127,1730,13109,37865,42868,31389,NA,NA,22131,3903,817,4597,1013,8500,1830,"Evans County, Georgia(7,9)",68.8,9,"Evans County, Georgia",54.8,7,stable,10787,13,109,54.8,68.8
GA,"Fannin County, Georgia",5404,2047,3357,13111,37049,37117,NA,80192,NA,33889,9310,2140,10093,2040,19403,4180,"Fannin County, Georgia(7,9)",73.2,29,"Fannin County, Georgia",46.6,20,falling,24303,13,111,46.6,73.2
GA,"Fayette County, Georgia",9129,3883,5246,13113,79066,78589,80639,65714,78424,51544,47425,4750,50925,4698,98350,9448,"Fayette County, Georgia(7,9)",47.4,57,"Fayette County, Georgia",34.1,40,falling,110714,13,113,34.1,47.4
GA,"Floyd County, Georgia",19605,9048,10557,13115,41549,46211,26090,NA,48675,31492,36663,8536,40916,7882,77579,16418,"Floyd County, Georgia(7,9)",81.1,92,"Floyd County, Georgia",55.5,63,falling,96504,13,115,55.5,81.1
GA,"Forsyth County, Georgia",13547,5932,7615,13117,88816,87872,74545,80913,117064,49496,85640,11472,87649,10870,173289,22342,"Forsyth County, Georgia(7,9)",60.6,90,"Forsyth County, Georgia",35,51,falling,212438,13,117,35,60.6
GA,"Franklin County, Georgia",5122,2253,2869,13119,33816,35323,23000,NA,NA,26964,8671,2036,9360,1836,18031,3872,"Franklin County, Georgia(7,9)",81.4,25,"Franklin County, Georgia",64.5,19,stable,22311,13,119,64.5,81.4
GA,"Fulton County, Georgia",167391,72577,94814,13121,57207,84666,36030,32048,93780,43655,395438,75916,432816,71007,828254,146923,"Fulton County, Georgia(7,8)",54.5,431,"Fulton County, Georgia",38.3,298,falling,1010562,13,121,38.3,54.5
GA,"Gilmer County, Georgia",6664,3541,3123,13123,40228,40731,NA,148125,151250,27931,10809,3588,11237,2791,22046,6379,"Gilmer County, Georgia(7,9)",76.1,32,"Gilmer County, Georgia",39.1,16,falling,29400,13,123,39.1,76.1
GA,"Glascock County, Georgia",483,237,246,13125,40759,44875,19514,NA,NA,NA,1233,242,1243,274,2476,516,"Glascock County, Georgia(7)",*,3 or fewer,"Glascock County, Georgia",*,*,**,3065,13,125,NA,NA
GA,"Glynn County, Georgia",14981,6339,8642,13127,45918,55254,26347,26397,40769,47688,30774,7351,35063,7594,65837,14945,"Glynn County, Georgia(7,9)",71.9,73,"Glynn County, Georgia",50.9,51,falling,83579,13,127,50.9,71.9
GA,"Gordon County, Georgia",11188,5321,5867,13129,41612,42847,25995,NA,52500,32918,21972,5414,22625,5339,44597,10753,"Gordon County, Georgia(7,9)",94.7,55,"Gordon County, Georgia",74.1,43,stable,56574,13,129,74.1,94.7
GA,"Grady County, Georgia",7648,3529,4119,13131,34187,41419,19654,NA,NA,17961,9315,3037,9964,2735,19279,5772,"Grady County, Georgia(7,9)",74,23,"Grady County, Georgia",64.5,19,stable,25205,13,131,64.5,74
GA,"Greene County, Georgia",4033,1870,2163,13133,42408,57795,22827,NA,49044,20473,6205,1667,6972,1310,13177,2977,"Greene County, Georgia(7)",69.9,19,"Greene County, Georgia",37.3,10,stable,16710,13,133,37.3,69.9
GA,"Gwinnett County, Georgia",117553,54558,62995,13135,60289,69649,52203,47143,57135,38924,330105,87272,355186,81567,685291,168839,"Gwinnett County, Georgia(7,8)",51.8,288,"Gwinnett County, Georgia",37.3,200,falling,895823,13,135,37.3,51.8
GA,"Habersham County, Georgia",7220,3357,3863,13137,40907,41470,30000,58750,44028,34929,16605,3957,16796,3866,33401,7823,"Habersham County, Georgia(7,9)",64.4,35,"Habersham County, Georgia",49.3,27,rising,43996,13,137,49.3,64.4
GA,"Hall County, Georgia",34120,16393,17727,13139,51202,53476,33260,NA,53400,39501,73737,19196,76493,17175,150230,36371,"Hall County, Georgia(7,9)",61.2,108,"Hall County, Georgia",45.6,81,falling,193535,13,139,45.6,61.2
GA,"Hancock County, Georgia",2113,835,1278,13141,24925,37994,22083,NA,NA,NA,2620,447,3321,625,5941,1072,"Hancock County, Georgia(7)",38.8,5,"Hancock County, Georgia",41.6,5,stable,8551,13,141,41.6,38.8
GA,"Haralson County, Georgia",5724,2583,3141,13143,41910,42532,32054,2499,36429,NA,11440,2323,12250,2189,23690,4512,"Haralson County, Georgia(7,9)",94.4,33,"Haralson County, Georgia",76,26,stable,28854,13,143,76,94.4
GA,"Harris County, Georgia",2991,1317,1674,13145,63824,74078,31464,NA,95139,103902,13962,1999,14769,1625,28731,3624,"Harris County, Georgia(7,9)",62,24,"Harris County, Georgia",45.8,17,stable,33381,13,145,45.8,62
GA,"Hart County, Georgia",5403,2421,2982,13147,37653,39567,24020,NA,NA,35610,9591,2477,10690,1905,20281,4382,"Hart County, Georgia(7,9)",69,25,"Hart County, Georgia",51.1,19,stable,25534,13,147,51.1,69
GA,"Heard County, Georgia",2349,1048,1301,13149,41525,42512,29650,13750,NA,18542,4696,946,4900,932,9596,1878,"Heard County, Georgia(7,9)",104.6,15,"Heard County, Georgia",64.6,9,stable,11539,13,149,64.6,104.6
GA,"Henry County, Georgia",27162,11870,15292,13151,60424,62010,58448,NA,72840,46703,85371,14877,94784,15133,180155,30010,"Henry County, Georgia(7,9)",60.3,102,"Henry County, Georgia",46.7,74,falling,217739,13,151,46.7,60.3
GA,"Houston County, Georgia",25111,10623,14488,13153,53270,58985,41191,28500,52375,53719,58947,10117,65869,9306,124816,19423,"Houston County, Georgia(7,9)",73.2,96,"Houston County, Georgia",56.4,72,stable,150033,13,153,56.4,73.2
GA,"Irwin County, Georgia",2300,1081,1219,13155,34156,42619,22332,NA,NA,NA,3483,913,3663,807,7146,1720,"Irwin County, Georgia(7,9)",83.4,10,"Irwin County, Georgia",68.5,8,stable,9245,13,155,68.5,83.4
GA,"Jackson County, Georgia",8314,3770,4544,13157,53379,54911,31625,47974,58750,47549,25164,4923,26283,4530,51447,9453,"Jackson County, Georgia(7,9)",78.4,50,"Jackson County, Georgia",62.1,37,stable,63360,13,157,62.1,78.4
GA,"Jasper County, Georgia",2785,1269,1516,13159,42368,43550,38393,NA,NA,NA,5250,1356,5831,1056,11081,2412,"Jasper County, Georgia(7)",78.7,12,"Jasper County, Georgia",45.2,7,stable,13635,13,159,45.2,78.7
GA,"Jeff Davis County, Georgia",3309,1383,1926,13161,36385,37822,20357,NA,NA,29866,5847,1475,5753,1799,11600,3274,"Jeff Davis County, Georgia(7,9)",76.2,13,"Jeff Davis County, Georgia",74.9,13,stable,14920,13,161,74.9,76.2
GA,"Jefferson County, Georgia",4889,2228,2661,13163,26557,41547,17467,55833,NA,15608,5460,2074,6623,1709,12083,3783,"Jefferson County, Georgia(7)",62.8,14,"Jefferson County, Georgia",68.8,14,stable,16106,13,163,68.8,62.8
GA,"Jenkins County, Georgia",2984,1335,1649,13165,24604,29552,19763,NA,NA,NA,3388,1032,3609,811,6997,1843,"Jenkins County, Georgia(7,9)",68.6,7,"Jenkins County, Georgia",60,6,**,8957,13,165,60,68.6
GA,"Johnson County, Georgia",2125,1064,1061,13167,34438,40158,16637,NA,NA,NA,4053,936,3524,722,7577,1658,"Johnson County, Georgia(7,9)",65.4,8,"Johnson County, Georgia",53.9,7,stable,9656,13,167,53.9,65.4
GA,"Jones County, Georgia",4770,2119,2651,13169,51857,56293,38529,NA,NA,86806,11697,2189,12775,1798,24472,3987,"Jones County, Georgia(7,9)",79.9,27,"Jones County, Georgia",56.7,18,stable,28494,13,169,56.7,79.9
GA,"Lamar County, Georgia",3713,1794,1919,13171,40344,47421,20448,NA,NA,36146,6918,1516,7795,1609,14713,3125,"Lamar County, Georgia(7,9)",86.5,18,"Lamar County, Georgia",70.7,15,stable,18201,13,171,70.7,86.5
GA,"Lanier County, Georgia",2675,1226,1449,13173,37605,44768,16422,NA,NA,36625,3545,1171,4178,968,7723,2139,"Lanier County, Georgia(7,9)",77.2,8,"Lanier County, Georgia",63.3,6,stable,10312,13,173,63.3,77.2
GA,"Laurens County, Georgia",12823,5604,7219,13175,32356,38798,20954,NA,NA,37019,18632,3499,21023,3685,39655,7184,"Laurens County, Georgia(7,9)",69.5,41,"Laurens County, Georgia",54.6,32,stable,47731,13,175,54.6,69.5
GA,"Lee County, Georgia",3417,1356,2061,13177,61537,64484,51638,NA,50833,NA,11578,1659,12983,1398,24561,3057,"Lee County, Georgia(7,9)",83.2,19,"Lee County, Georgia",62.2,14,stable,29202,13,177,62.2,83.2
GA,"Liberty County, Georgia",11047,4963,6084,13179,42201,44140,40170,35694,45833,43938,22886,4140,27203,3953,50089,8093,"Liberty County, Georgia(7,9)",76.8,30,"Liberty County, Georgia",46.7,18,falling,62467,13,179,46.7,76.8
GA,"Lincoln County, Georgia",1912,799,1113,13181,34243,36931,27500,NA,NA,NA,3005,613,3339,676,6344,1289,"Lincoln County, Georgia(7,9)",65.3,7,"Lincoln County, Georgia",54.5,6,stable,7673,13,181,54.5,65.3
GA,"Long County, Georgia",2936,1244,1692,13183,48863,51000,41222,18813,NA,29259,5944,1405,7095,1139,13039,2544,"Long County, Georgia(7,9)",88.9,10,"Long County, Georgia",60.6,7,stable,17731,13,183,60.6,88.9
GA,"Lowndes County, Georgia",28907,13270,15637,13185,36834,45193,24116,103971,29704,27230,40735,10962,46699,10123,87434,21085,"Lowndes County, Georgia(7,9)",65.3,62,"Lowndes County, Georgia",52.8,49,falling,112865,13,185,52.8,65.3
GA,"Lumpkin County, Georgia",5559,2398,3161,13187,43804,44625,NA,NA,NA,43571,12100,2752,13756,1907,25856,4659,"Lumpkin County, Georgia(7,9)",72.3,24,"Lumpkin County, Georgia",50,16,stable,31408,13,187,50,72.3
GA,"McDuffie County, Georgia",5410,2397,3013,13189,36656,50554,22130,NA,NA,17679,8135,1936,9121,2099,17256,4035,"McDuffie County, Georgia(7,9)",69.5,18,"McDuffie County, Georgia",57.6,14,stable,21540,13,189,57.6,69.5
GA,"McIntosh County, Georgia",2956,1296,1660,13191,42988,50587,27511,NA,NA,55948,5469,1281,6025,1132,11494,2413,"McIntosh County, Georgia(7,9)",55,11,"McIntosh County, Georgia",39.5,8,falling,13969,13,191,39.5,55
GA,"Macon County, Georgia",3639,1541,2098,13193,28684,41875,17660,NA,56645,NA,4552,1488,5046,1199,9598,2687,"Macon County, Georgia(7,9)",69,11,"Macon County, Georgia",55.9,9,stable,13632,13,193,55.9,69
GA,"Madison County, Georgia",4798,2176,2622,13195,41912,42850,30750,45750,NA,28886,11295,2515,12103,2143,23398,4658,"Madison County, Georgia(7,9)",90.4,31,"Madison County, Georgia",70.8,23,stable,28441,13,195,70.8,90.4
GA,"Marion County, Georgia",1836,640,1196,13197,36242,39266,26210,NA,NA,223750,3072,1249,3655,663,6727,1912,"Marion County, Georgia(7,9)",64.6,7,"Marion County, Georgia",56.7,6,**,8761,13,197,56.7,64.6
GA,"Meriwether County, Georgia",4733,2135,2598,13199,35832,44852,24829,NA,NA,NA,8287,1832,9123,1925,17410,3757,"Meriwether County, Georgia(7,9)",66.8,19,"Meriwether County, Georgia",54,15,stable,21190,13,199,54,66.8
GA,"Miller County, Georgia",1608,648,960,13201,33983,42076,17279,NA,NA,NA,2210,518,2575,471,4785,989,"Miller County, Georgia(7,9)",89.1,8,"Miller County, Georgia",64.8,6,**,5854,13,201,64.8,89.1
GA,"Mitchell County, Georgia",5905,2385,3520,13205,31915,39833,25763,NA,NA,28929,7804,2078,8547,2342,16351,4420,"Mitchell County, Georgia(7,9)",85.1,23,"Mitchell County, Georgia",56.2,15,falling,22574,13,205,56.2,85.1
GA,"Monroe County, Georgia",3492,1480,2012,13207,48744,54655,22596,NA,NA,58958,10708,1782,11425,1731,22133,3513,"Monroe County, Georgia(7,9)",72.7,24,"Monroe County, Georgia",41,13,falling,27103,13,207,41,72.7
GA,"Montgomery County, Georgia",2076,979,1097,13209,34672,38542,25243,NA,NA,36250,3344,832,3630,785,6974,1617,"Montgomery County, Georgia(7,9)",71.7,7,"Montgomery County, Georgia",66.8,6,stable,8951,13,209,66.8,71.7
GA,"Morgan County, Georgia",2529,1047,1482,13211,51820,58421,32572,NA,NA,NA,7275,1122,7953,1354,15228,2476,"Morgan County, Georgia(7)",65.5,16,"Morgan County, Georgia",49.2,11,falling,18046,13,211,49.2,65.5
GA,"Murray County, Georgia",7765,3685,4080,13213,35539,35208,NA,NA,NA,48656,14877,4265,16243,3793,31120,8058,"Murray County, Georgia(7,9)",103.1,42,"Murray County, Georgia",69.7,28,falling,39565,13,213,69.7,103.1
GA,"Muscogee County, Georgia",38921,16697,22224,13215,42306,53668,32351,61741,62361,39164,71343,14830,87018,13855,158361,28685,"Muscogee County, Georgia(7,9)",70.3,134,"Muscogee County, Georgia",51.7,99,falling,200579,13,215,51.7,70.3
GA,"Newton County, Georgia",17281,7478,9803,13217,49179,51827,46070,31875,62557,41530,40481,7653,45244,8348,85725,16001,"Newton County, Georgia(7,9)",78.9,69,"Newton County, Georgia",59.5,51,stable,105473,13,217,59.5,78.9
GA,"Oconee County, Georgia",2487,1084,1403,13219,72182,73102,42399,250001,130643,50724,14971,1716,15812,1701,30783,3417,"Oconee County, Georgia(7,9)",46.8,15,"Oconee County, Georgia",34.3,11,falling,35965,13,219,34.3,46.8
GA,"Oglethorpe County, Georgia",2316,1054,1262,13221,44226,49177,24881,NA,NA,40464,6078,1142,6369,957,12447,2099,"Oglethorpe County, Georgia(7,9)",75.4,14,"Oglethorpe County, Georgia",44.5,8,stable,14871,13,221,44.5,75.4
GA,"Paulding County, Georgia",18445,7439,11006,13223,60109,60992,57598,60068,48077,52163,61605,10000,65284,9849,126889,19849,"Paulding County, Georgia(7,9)",77.7,83,"Paulding County, Georgia",51.9,51,falling,152238,13,223,51.9,77.7
GA,"Peach County, Georgia",5471,2439,3032,13225,41588,54362,32062,NA,NA,26215,10354,2667,11558,2377,21912,5044,"Peach County, Georgia(7,9)",77.9,22,"Peach County, Georgia",71.9,20,stable,26720,13,225,71.9,77.9
GA,"Pickens County, Georgia",3418,1479,1939,13227,54123,54863,NA,NA,NA,NA,12454,2293,12939,1782,25393,4075,"Pickens County, Georgia(7,9)",82.3,34,"Pickens County, Georgia",54,22,stable,30309,13,227,54,82.3
GA,"Pierce County, Georgia",4455,2269,2186,13229,40247,43400,15809,NA,NA,34655,7350,1945,7718,1777,15068,3722,"Pierce County, Georgia(7,9)",80.1,18,"Pierce County, Georgia",70.5,16,stable,19103,13,229,70.5,80.1
GA,"Pike County, Georgia",2132,1008,1124,13231,51338,53792,32500,NA,NA,NA,7234,1444,7439,1428,14673,2872,"Pike County, Georgia(7,9)",75.6,15,"Pike County, Georgia",62.9,12,stable,17941,13,231,62.9,75.6
GA,"Polk County, Georgia",8767,3831,4936,13233,37853,39732,28987,NA,37756,51033,15636,4410,17711,3149,33347,7559,"Polk County, Georgia(7,9)",102,48,"Polk County, Georgia",77.5,37,stable,41524,13,233,77.5,102
GA,"Pulaski County, Georgia",1929,655,1274,13235,38750,46435,22250,NA,NA,26208,3916,858,4421,852,8337,1710,"Pulaski County, Georgia(7,9)",50.6,8,"Pulaski County, Georgia",37.8,6,stable,11396,13,235,37.8,50.6
GA,"Putnam County, Georgia",3446,1912,1534,13237,44299,54436,32725,NA,NA,27053,8179,2278,9375,1249,17554,3527,"Putnam County, Georgia(7)",74.4,23,"Putnam County, Georgia",55.9,17,stable,21353,13,237,55.9,74.4
GA,"Quitman County, Georgia",558,208,350,13239,31487,32069,27049,NA,NA,NA,855,251,1046,174,1901,425,"Quitman County, Georgia(7,9)",110.8,5,"Quitman County, Georgia",87.2,4,**,2302,13,239,87.2,110.8
GA,"Rabun County, Georgia",3458,1544,1914,13241,35211,37178,NA,NA,NA,NA,5685,2167,6431,1784,12116,3951,"Rabun County, Georgia(7,9)",67.1,18,"Rabun County, Georgia",46.3,13,falling,16281,13,241,46.3,67.1
GA,"Randolph County, Georgia",2145,1079,1066,13243,28377,45208,22054,NA,NA,NA,2791,888,2898,620,5689,1508,"Randolph County, Georgia(7,9)",56.6,6,"Randolph County, Georgia",40.9,5,stable,7193,13,243,40.9,56.6
GA,"Richmond County, Georgia",48498,20943,27555,13245,37424,46154,31130,34861,42050,43258,73605,15946,86184,15914,159789,31860,"Richmond County, Georgia(7,9)",72.7,148,"Richmond County, Georgia",56.8,113,falling,201793,13,245,56.8,72.7
GA,"Rockdale County, Georgia",14155,6535,7620,13247,50455,50519,50814,NA,54375,34393,32871,7965,36981,8361,69852,16326,"Rockdale County, Georgia(7,9)",60.7,49,"Rockdale County, Georgia",40.3,32,falling,88856,13,247,40.3,60.7
GA,"Schley County, Georgia",1187,512,675,13249,39375,48864,20117,NA,NA,NA,1907,610,2016,541,3923,1151,"Schley County, Georgia(7,9)",69.9,4,"Schley County, Georgia",*,*,*,5168,13,249,NA,69.9
GA,"Screven County, Georgia",3482,1551,1931,13251,34466,42857,22873,NA,NA,NA,5274,1358,5852,1327,11126,2685,"Screven County, Georgia(7,9)",79.1,15,"Screven County, Georgia",57,10,stable,14162,13,251,57,79.1
GA,"Seminole County, Georgia",1595,594,1001,13253,34905,42863,21538,NA,NA,34398,3165,893,3756,849,6921,1742,"Seminole County, Georgia(7,9)",66.4,9,"Seminole County, Georgia",38.8,5,**,8647,13,253,38.8,66.4
GA,"Spalding County, Georgia",14238,5975,8263,13255,40246,48097,24870,42885,36299,33025,24186,5838,28153,4617,52339,10455,"Spalding County, Georgia(7,9)",74.3,55,"Spalding County, Georgia",52.2,38,falling,64051,13,255,52.2,74.3
GA,"Stephens County, Georgia",4707,2468,2239,13257,40315,42979,23784,NA,NA,NA,10161,2186,11520,1748,21681,3934,"Stephens County, Georgia(7,9)",76.8,27,"Stephens County, Georgia",63.1,22,stable,25586,13,257,63.1,76.8
GA,"Stewart County, Georgia",1645,693,952,13259,21118,45833,15295,NA,NA,NA,1401,648,1860,389,3261,1037,"Stewart County, Georgia(7,9)",65.5,4,"Stewart County, Georgia",65,4,stable,5851,13,259,65,65.5
GA,"Sumter County, Georgia",9741,4124,5617,13261,32758,46492,22610,NA,33952,22284,11738,2388,13950,2450,25688,4838,"Sumter County, Georgia(7,9)",63.1,22,"Sumter County, Georgia",48.6,17,stable,30779,13,261,48.6,63.1
GA,"Talbot County, Georgia",1291,630,661,13263,34078,40513,25156,NA,NA,62083,2635,485,2787,563,5422,1048,"Talbot County, Georgia(7,9)",73.2,7,"Talbot County, Georgia",61.4,5,stable,6337,13,263,61.4,73.2
GA,"Taliaferro County, Georgia",511,195,316,13265,26306,33417,23531,NA,NA,NA,620,209,748,144,1368,353,"Taliaferro County, Georgia(7)",*,3 or fewer,"Taliaferro County, Georgia",*,*,**,1639,13,265,NA,NA
GA,"Tattnall County, Georgia",5646,2173,3473,13267,33980,40830,18161,NA,NA,24150,7168,1613,8696,1947,15864,3560,"Tattnall County, Georgia(7,9)",100.8,26,"Tattnall County, Georgia",79.1,20,stable,25229,13,267,79.1,100.8
GA,"Taylor County, Georgia",2351,1041,1310,13269,28143,36079,20049,NA,NA,NA,2958,903,3593,739,6551,1642,"Taylor County, Georgia(7,9)",54.2,6,"Taylor County, Georgia",43.1,5,stable,8330,13,269,43.1,54.2
GA,"Telfair County, Georgia",3565,1401,2164,13271,26449,30054,20500,NA,NA,29278,4484,1276,5636,1127,10120,2403,"Telfair County, Georgia(7,9)",55.1,11,"Telfair County, Georgia",45.6,9,falling,16400,13,271,45.6,55.1
GA,"Terrell County, Georgia",3216,1329,1887,13273,28688,50152,19776,NA,NA,NA,3138,942,3922,881,7060,1823,"Terrell County, Georgia(7,9)",63,8,"Terrell County, Georgia",53.7,6,falling,9113,13,273,53.7,63
GA,"Thomas County, Georgia",10335,4943,5392,13275,36641,45275,24514,NA,50779,32552,16665,4194,19432,3831,36097,8025,"Thomas County, Georgia(7,9)",74.5,41,"Thomas County, Georgia",60.6,34,stable,45063,13,275,60.6,74.5
GA,"Tift County, Georgia",11372,4841,6531,13277,37653,47480,23706,NA,NA,27198,14468,4956,16409,4533,30877,9489,"Tift County, Georgia(7,9)",71.4,31,"Tift County, Georgia",54.1,23,falling,40764,13,277,54.1,71.4
GA,"Toombs County, Georgia",6674,2769,3905,13279,33679,41875,22629,NA,NA,28851,9405,3180,11303,2984,20708,6164,"Toombs County, Georgia(7,9)",74,23,"Toombs County, Georgia",58.6,18,falling,27241,13,279,58.6,74
GA,"Towns County, Georgia",1862,817,1045,13281,37000,37199,NA,NA,NA,NA,4375,762,4735,764,9110,1526,"Towns County, Georgia(7,9)",62.4,15,"Towns County, Georgia",56.5,12,stable,11182,13,281,56.5,62.4
GA,"Treutlen County, Georgia",1242,491,751,13283,38596,45664,21974,NA,NA,NA,2427,519,2918,501,5345,1020,"Treutlen County, Georgia(7,9)",78.5,6,"Treutlen County, Georgia",61,5,stable,6785,13,283,61,78.5
GA,"Troup County, Georgia",14388,5631,8757,13285,41489,49748,27204,NA,72557,51004,26673,5391,30199,5172,56872,10563,"Troup County, Georgia(7,9)",71.1,52,"Troup County, Georgia",50.6,37,falling,69763,13,285,50.6,71.1
GA,"Turner County, Georgia",2027,1067,960,13287,31806,41092,24082,NA,NA,2499,2846,1128,3240,770,6086,1898,"Turner County, Georgia(7,9)",80.4,9,"Turner County, Georgia",54.9,6,stable,8214,13,287,54.9,80.4
GA,"Twiggs County, Georgia",2324,976,1348,13289,30468,38080,20438,NA,NA,NA,3447,682,3660,630,7107,1312,"Twiggs County, Georgia(7,9)",91.8,12,"Twiggs County, Georgia",57.2,7,stable,8390,13,289,57.2,91.8
GA,"Union County, Georgia",2860,1353,1507,13291,40799,40645,NA,NA,48050,56319,8616,1695,9628,1331,18244,3026,"Union County, Georgia(7,9)",70.4,30,"Union County, Georgia",43.5,18,stable,22267,13,291,43.5,70.4
GA,"Upson County, Georgia",6137,2988,3149,13293,35774,39387,27769,NA,NA,25136,10356,1973,11483,2142,21839,4115,"Upson County, Georgia(7,9)",87.8,31,"Upson County, Georgia",56.5,20,stable,26368,13,293,56.5,87.8
GA,"Walker County, Georgia",11818,5435,6383,13295,41632,42330,30093,NA,NA,57926,27895,4896,28522,5676,56417,10572,"Walker County, Georgia(7,9)",84.3,72,"Walker County, Georgia",76.4,65,stable,68066,13,295,76.4,84.3
GA,"Walton County, Georgia",11801,4642,7159,13297,54453,57341,32407,21783,82011,64000,36422,5187,37677,6185,74099,11372,"Walton County, Georgia(7,9)",67.9,61,"Walton County, Georgia",53.5,47,falling,88399,13,297,53.5,67.9
GA,"Ware County, Georgia",9686,3807,5879,13299,34909,40436,24617,NA,NA,37813,12488,3237,14200,3448,26688,6685,"Ware County, Georgia(7,9)",70.6,32,"Ware County, Georgia",50.6,22,stable,35370,13,299,50.6,70.6
GA,"Warren County, Georgia",1485,619,866,13301,29176,42344,19915,NA,NA,NA,2094,438,2470,481,4564,919,"Warren County, Georgia(7)",84.9,7,"Warren County, Georgia",70.4,6,stable,5460,13,301,70.4,84.9
GA,"Washington County, Georgia",4961,2052,2909,13303,37932,52253,23329,NA,NA,21477,7449,1569,8563,1594,16012,3163,"Washington County, Georgia(7)",68.2,17,"Washington County, Georgia",49.4,12,stable,20816,13,303,49.4,68.2
GA,"Wayne County, Georgia",5633,2316,3317,13305,38955,44301,22129,12212,NA,26875,10408,3006,11328,3135,21736,6141,"Wayne County, Georgia(7,9)",76.2,25,"Wayne County, Georgia",59.3,19,stable,29534,13,305,59.3,76.2
GA,"Webster County, Georgia",608,222,386,13307,37063,51544,30120,NA,NA,NA,1238,127,1078,272,2316,399,"Webster County, Georgia(7,9)",*,3 or fewer,"Webster County, Georgia",*,*,**,2648,13,307,NA,NA
GA,"Wheeler County, Georgia",1177,404,773,13309,27620,30807,15475,NA,NA,NA,1508,335,1962,544,3470,879,"Wheeler County, Georgia(7,9)",62.8,5,"Wheeler County, Georgia",51.2,4,stable,7903,13,309,51.2,62.8
GA,"White County, Georgia",5195,2364,2831,13311,40888,41737,32250,NA,NA,31508,11160,2236,11932,2264,23092,4500,"White County, Georgia(7,9)",69.8,27,"White County, Georgia",47.3,17,stable,28319,13,311,47.3,69.8
GA,"Whitfield County, Georgia",19270,8532,10738,13313,40596,41076,26577,NA,52188,36447,39089,11898,40821,10887,79910,22785,"Whitfield County, Georgia(7,9)",77.6,79,"Whitfield County, Georgia",64.5,64,stable,104216,13,313,64.5,77.6
GA,"Wilcox County, Georgia",1599,675,924,13315,32043,38750,21512,NA,NA,NA,2808,532,3002,597,5810,1129,"Wilcox County, Georgia(7,9)",64.9,7,"Wilcox County, Georgia",45.7,5,**,8857,13,315,45.7,64.9
GA,"Wilkes County, Georgia",2795,1122,1673,13317,32727,43893,20518,NA,26705,30385,3817,797,4416,788,8233,1585,"Wilkes County, Georgia(7,9)",66,10,"Wilkes County, Georgia",57.7,9,stable,9867,13,317,57.7,66
GA,"Wilkinson County, Georgia",1640,661,979,13319,38485,44931,26989,NA,NA,37813,3862,674,4275,476,8137,1150,"Wilkinson County, Georgia(7,9)",79.9,11,"Wilkinson County, Georgia",56.9,8,stable,9155,13,319,56.9,79.9
GA,"Worth County, Georgia",4445,1961,2484,13321,37974,44709,24994,NA,NA,30688,7876,2283,8636,2197,16512,4480,"Worth County, Georgia(7,9)",70.8,19,"Worth County, Georgia",51.3,13,stable,20699,13,321,51.3,70.8
HI,"Hawaii County, Hawaii",36756,17957,18799,15001,52108,52303,50221,28003,56380,41302,86553,8577,88674,6523,175227,15100,"Hawaii County, Hawaii(7,9)",44.9,107,"Hawaii County, Hawaii",33.3,79,**,196428,15,1,33.3,44.9
HI,"Honolulu County, Hawaii",92404,41559,50845,15003,74460,75175,62866,50593,77807,61601,429201,26111,457423,20975,886624,47086,"Honolulu County, Hawaii(7,9)",48.3,550,"Honolulu County, Hawaii",32.9,377,**,998714,15,3,32.9,48.3
HI,"Kalawao County, Hawaii",12,5,7,15005,66250,NA,NA,NA,NA,NA,32,4,35,4,67,8,"Kalawao County, Hawaii(7,9)",*,3 or fewer,"Kalawao County, Hawaii",*,*,**,89,15,5,NA,NA
HI,"Kauai County, Hawaii",7384,3291,4093,15007,65101,62964,66172,78605,66174,59022,31135,3317,32223,2228,63358,5545,"Kauai County, Hawaii(7,9)",45.2,39,"Kauai County, Hawaii",34.6,30,**,71735,15,7,34.6,45.2
HI,"Maui County, Hawaii",17388,7899,9489,15009,66476,62763,49893,49375,74310,50297,72806,6977,74047,5505,146853,12482,"Maui County, Hawaii(7,9)",43.2,80,"Maui County, Hawaii",28.6,51,**,164637,15,9,28.6,43.2
IA,"Adair County, Iowa",764,274,490,19001,46526,46330,NA,NA,NA,NA,3329,296,3429,233,6758,529,"Adair County, Iowa(7,8)",65.2,8,"Adair County, Iowa",42.3,5,stable,7228,19,1,42.3,65.2
IA,"Adams County, Iowa",388,177,211,19003,48043,48587,NA,NA,NA,NA,1787,128,1782,125,3569,253,"Adams County, Iowa(7,8)",68.9,4,"Adams County, Iowa",*,*,*,3796,19,3,NA,68.9
IA,"Allamakee County, Iowa",1491,620,871,19005,45890,46212,19886,NA,NA,32863,6267,742,6077,667,12344,1409,"Allamakee County, Iowa(7,8)",39.9,9,"Allamakee County, Iowa",35.3,8,**,13886,19,5,35.3,39.9
IA,"Appanoose County, Iowa",1719,749,970,19007,41394,41801,NA,NA,NA,NA,5533,706,5627,672,11160,1378,"Appanoose County, Iowa(7,8)",78.5,15,"Appanoose County, Iowa",56.3,11,stable,12529,19,7,56.3,78.5
IA,"Audubon County, Iowa",552,204,348,19009,46979,46840,NA,NA,NA,NA,2562,254,2676,227,5238,481,"Audubon County, Iowa(7,8)",42.4,4,"Audubon County, Iowa",*,*,**,5773,19,9,NA,42.4
IA,"Benton County, Iowa",2440,1215,1225,19011,60606,60820,NA,16250,NA,NA,12198,616,12243,509,24441,1125,"Benton County, Iowa(7,8)",67.5,22,"Benton County, Iowa",50.2,17,stable,25658,19,11,50.2,67.5
IA,"Black Hawk County, Iowa",19887,8889,10998,19013,48369,51200,25471,NA,51528,34397,59036,5024,62677,4475,121713,9499,"Black Hawk County, Iowa(7,8)",72.5,108,"Black Hawk County, Iowa",56.3,84,stable,133455,19,13,56.3,72.5
IA,"Boone County, Iowa",2588,1093,1495,19015,52985,52616,NA,NA,NA,40938,11723,1177,12144,725,23867,1902,"Boone County, Iowa(7,8)",61.3,21,"Boone County, Iowa",47.4,17,stable,26643,19,15,47.4,61.3
IA,"Bremer County, Iowa",1894,671,1223,19017,62163,62058,125208,NA,NA,73500,11386,568,11904,318,23290,886,"Bremer County, Iowa(7,8)",41.6,14,"Bremer County, Iowa",31.7,10,stable,24722,19,17,31.7,41.6
IA,"Buchanan County, Iowa",1970,843,1127,19019,56150,56487,NA,NA,NA,NA,9284,996,9578,887,18862,1883,"Buchanan County, Iowa(7,8)",82.8,21,"Buchanan County, Iowa",56.2,15,stable,21062,19,19,56.2,82.8
IA,"Buena Vista County, Iowa",2452,1068,1384,19021,48195,49912,19104,NA,74883,46411,9022,1388,8938,886,17960,2274,"Buena Vista County, Iowa(7,8)",40.9,10,"Buena Vista County, Iowa",28.4,7,stable,20493,19,21,28.4,40.9
IA,"Butler County, Iowa",1322,533,789,19023,52360,52265,NA,NA,NA,NA,6876,437,6901,491,13777,928,"Butler County, Iowa(7,8)",45.4,10,"Butler County, Iowa",35.4,8,stable,14915,19,23,35.4,45.4
IA,"Calhoun County, Iowa",1384,658,726,19025,44921,44842,NA,NA,73125,40000,4349,298,4471,263,8820,561,"Calhoun County, Iowa(7,8)",54.6,9,"Calhoun County, Iowa",40.4,7,stable,9818,19,25,40.4,54.6
IA,"Carroll County, Iowa",2047,675,1372,19027,50559,51558,13689,NA,NA,48750,9502,392,9945,427,19447,819,"Carroll County, Iowa(7,8)",60.8,18,"Carroll County, Iowa",44.4,14,stable,20498,19,27,44.4,60.8
IA,"Cass County, Iowa",1855,888,967,19029,43750,43972,NA,20750,NA,47917,6042,505,6474,308,12516,813,"Cass County, Iowa(7,8)",73.2,15,"Cass County, Iowa",57.1,12,stable,13427,19,29,57.1,73.2
IA,"Cedar County, Iowa",1393,615,778,19031,59047,58619,NA,NA,58750,70278,8437,466,8851,379,17288,845,"Cedar County, Iowa(7,8)",66.5,16,"Cedar County, Iowa",40.6,10,stable,18340,19,31,40.6,66.5
IA,"Cerro Gordo County, Iowa",5665,2333,3332,19033,46122,46361,38628,NA,41125,37011,19432,1546,20426,1418,39858,2964,"Cerro Gordo County, Iowa(7,8)",65.8,43,"Cerro Gordo County, Iowa",41.7,27,falling,43017,19,33,41.7,65.8
IA,"Cherokee County, Iowa",1281,565,716,19035,48599,48558,NA,NA,NA,22193,5309,509,5252,390,10561,899,"Cherokee County, Iowa(7,8)",47.6,10,"Cherokee County, Iowa",36.3,8,stable,11574,19,35,36.3,47.6
IA,"Chickasaw County, Iowa",1067,493,574,19037,47040,47344,NA,NA,NA,30556,5706,396,5630,384,11336,780,"Chickasaw County, Iowa(7,8)",52.9,10,"Chickasaw County, Iowa",44,8,stable,12097,19,37,44,52.9
IA,"Clarke County, Iowa",1493,658,835,19039,43327,42865,NA,NA,NA,23932,3958,680,4065,439,8023,1119,"Clarke County, Iowa(7,8)",70.6,9,"Clarke County, Iowa",58.4,7,stable,9259,19,39,58.4,70.6
IA,"Clay County, Iowa",1848,727,1121,19041,50389,51044,NA,NA,NA,26445,7388,616,7707,544,15095,1160,"Clay County, Iowa(7,8)",57.8,13,"Clay County, Iowa",41.5,10,stable,16507,19,41,41.5,57.8
IA,"Clayton County, Iowa",1941,799,1142,19043,48007,48023,NA,NA,51154,35250,8115,684,8114,656,16229,1340,"Clayton County, Iowa(7,8)",60.3,16,"Clayton County, Iowa",37.1,10,stable,17644,19,43,37.1,60.3
IA,"Clinton County, Iowa",6608,2840,3768,19045,50498,52613,19125,NA,14420,43678,21990,1640,22956,1284,44946,2924,"Clinton County, Iowa(7,8)",64.1,42,"Clinton County, Iowa",50.5,33,falling,47768,19,45,50.5,64.1
IA,"Crawford County, Iowa",3367,1594,1773,19047,48084,47846,NA,58401,NA,41985,7484,1129,7631,807,15115,1936,"Crawford County, Iowa(7,8)",54.8,12,"Crawford County, Iowa",33.6,8,stable,17094,19,47,33.6,54.8
IA,"Dallas County, Iowa",4796,2038,2758,19049,76320,77282,41075,NA,78794,57583,34604,2002,36040,1736,70644,3738,"Dallas County, Iowa(7,8)",61.6,38,"Dallas County, Iowa",36.7,22,falling,80133,19,49,36.7,61.6
IA,"Davis County, Iowa",1657,662,995,19051,48888,48842,NA,NA,86000,70250,3242,1023,3150,1212,6392,2235,"Davis County, Iowa(7,8)",53.6,6,"Davis County, Iowa",36.9,4,stable,8769,19,51,36.9,53.6
IA,"Decatur County, Iowa",1541,722,819,19053,38560,38682,NA,8580,NA,NA,3601,468,3449,622,7050,1090,"Decatur County, Iowa(7,8)",65,7,"Decatur County, Iowa",40.5,5,stable,8220,19,53,40.5,65
IA,"Delaware County, Iowa",1717,855,862,19055,58274,58612,NA,NA,NA,14671,8234,452,8359,297,16593,749,"Delaware County, Iowa(7,8)",38.4,9,"Delaware County, Iowa",25.7,6,falling,17403,19,55,25.7,38.4
IA,"Des Moines County, Iowa",6010,2095,3915,19057,44423,45519,19318,NA,76375,23700,17543,1763,19146,1255,36689,3018,"Des Moines County, Iowa(7,8)",86.7,49,"Des Moines County, Iowa",58.6,33,stable,40055,19,57,58.6,86.7
IA,"Dickinson County, Iowa",1100,433,667,19059,57265,57324,NA,NA,NA,117841,7864,524,7901,469,15765,993,"Dickinson County, Iowa(7,8)",59.6,18,"Dickinson County, Iowa",41.3,12,stable,17111,19,59,41.3,59.6
IA,"Dubuque County, Iowa",11189,4826,6363,19061,54605,55889,18625,2499,47083,36944,44017,2826,45546,2267,89563,5093,"Dubuque County, Iowa(7,8)",59.4,70,"Dubuque County, Iowa",46.7,56,falling,97125,19,61,46.7,59.4
IA,"Emmet County, Iowa",1250,524,726,19063,47795,47732,NA,NA,NA,60324,4217,614,4425,389,8642,1003,"Emmet County, Iowa(7,8)",69.8,10,"Emmet County, Iowa",45.3,7,stable,9769,19,63,45.3,69.8
IA,"Fayette County, Iowa",2550,1189,1361,19065,44928,45513,8843,NA,NA,37759,9182,997,9220,835,18402,1832,"Fayette County, Iowa(7,8)",59.9,19,"Fayette County, Iowa",40.2,13,stable,20257,19,65,40.2,59.9
IA,"Floyd County, Iowa",1957,836,1121,19067,44797,44947,NA,NA,NA,54083,7168,721,7339,613,14507,1334,"Floyd County, Iowa(7,8)",65.7,16,"Floyd County, Iowa",55.1,13,stable,15960,19,67,55.1,65.7
IA,"Franklin County, Iowa",1372,651,721,19069,48605,50241,2499,NA,NA,31411,4792,399,4761,384,9553,783,"Franklin County, Iowa(7,8)",54.7,8,"Franklin County, Iowa",45.3,7,rising,10295,19,69,45.3,54.7
IA,"Fremont County, Iowa",757,372,385,19071,53324,53647,NA,NA,NA,42500,3162,317,3270,234,6432,551,"Fremont County, Iowa(7,8)",76.2,8,"Fremont County, Iowa",63,7,stable,6906,19,71,63,76.2
IA,"Greene County, Iowa",1135,460,675,19073,46898,47261,NA,NA,80000,67700,4174,252,4412,221,8586,473,"Greene County, Iowa(7,8)",63.7,9,"Greene County, Iowa",56.4,8,stable,9027,19,73,56.4,63.7
IA,"Grundy County, Iowa",757,288,469,19075,56750,56648,NA,NA,NA,NA,5728,300,6002,225,11730,525,"Grundy County, Iowa(7,8)",48.7,9,"Grundy County, Iowa",33.5,6,stable,12435,19,75,33.5,48.7
IA,"Guthrie County, Iowa",1199,515,684,19077,51013,51382,NA,NA,NA,57500,4793,474,4992,343,9785,817,"Guthrie County, Iowa(7,8)",55.6,9,"Guthrie County, Iowa",51.9,9,stable,10676,19,77,51.9,55.6
IA,"Hamilton County, Iowa",1712,700,1012,19079,49813,51702,43710,NA,32132,NA,6519,842,7204,528,13723,1370,"Hamilton County, Iowa(7,8)",64.7,14,"Hamilton County, Iowa",41,9,stable,15190,19,79,41,64.7
IA,"Hancock County, Iowa",924,413,511,19081,52981,53187,NA,NA,NA,30500,5254,289,5137,260,10391,549,"Hancock County, Iowa(7,8)",58.8,9,"Hancock County, Iowa",47.4,8,stable,10974,19,81,47.4,58.8
IA,"Hardin County, Iowa",1454,584,870,19083,51019,50965,NA,28992,66833,47989,7755,617,7942,535,15697,1152,"Hardin County, Iowa(7,8)",58.5,16,"Hardin County, Iowa",46.9,13,stable,17367,19,83,46.9,58.5
IA,"Harrison County, Iowa",1398,633,765,19085,53567,53709,NA,NA,NA,38365,6389,699,6658,472,13047,1171,"Harrison County, Iowa(7,8)",86.4,18,"Harrison County, Iowa",48.3,10,stable,14265,19,85,48.3,86.4
IA,"Henry County, Iowa",2695,1303,1392,19087,49321,48938,NA,NA,51938,32304,8589,702,8945,648,17534,1350,"Henry County, Iowa(7,8)",70.4,18,"Henry County, Iowa",51.5,13,stable,19950,19,87,51.5,70.4
IA,"Howard County, Iowa",1081,472,609,19089,49869,50151,NA,NA,NA,NA,4305,326,4313,376,8618,702,"Howard County, Iowa(7,8)",41.9,6,"Howard County, Iowa",35.7,5,stable,9410,19,89,35.7,41.9
IA,"Humboldt County, Iowa",1155,447,708,19091,47252,47466,NA,NA,NA,27188,4394,301,4616,246,9010,547,"Humboldt County, Iowa(7,8)",54.5,9,"Humboldt County, Iowa",31,5,stable,9555,19,91,31,54.5
IA,"Ida County, Iowa",809,395,414,19093,46993,47633,NA,NA,NA,29750,3226,300,3149,267,6375,567,"Ida County, Iowa(7,8)",55.6,6,"Ida County, Iowa",41.7,5,**,7028,19,93,41.7,55.6
IA,"Iowa County, Iowa",1391,615,776,19095,59375,60325,NA,NA,NA,81287,7475,521,7678,421,15153,942,"Iowa County, Iowa(7,8)",47.5,11,"Iowa County, Iowa",40.6,9,stable,16401,19,95,40.6,47.5
IA,"Jackson County, Iowa",2343,899,1444,19097,49028,49616,NA,NA,NA,53534,8854,774,8959,794,17813,1568,"Jackson County, Iowa(7,8)",66.1,18,"Jackson County, Iowa",53.8,15,stable,19444,19,97,53.8,66.1
IA,"Jasper County, Iowa",3342,1456,1886,19099,55033,55551,36635,NA,NA,NA,15903,1312,16644,1164,32547,2476,"Jasper County, Iowa(7,8)",72.4,36,"Jasper County, Iowa",53.8,27,stable,36827,19,99,53.8,72.4
IA,"Jefferson County, Iowa",2311,1294,1017,19101,42899,43615,NA,NA,2499,NA,7808,1132,7504,729,15312,1861,"Jefferson County, Iowa(7,8)",49.5,11,"Jefferson County, Iowa",34.6,7,stable,17555,19,101,34.6,49.5
IA,"Johnson County, Iowa",23537,11609,11928,19103,55700,60022,27608,NA,39875,48688,62291,5726,65282,4449,127573,10175,"Johnson County, Iowa(7,8)",50.5,53,"Johnson County, Iowa",36.7,37,stable,144251,19,103,36.7,50.5
IA,"Jones County, Iowa",1950,828,1122,19105,55060,55341,NA,NA,NA,33641,8896,559,9288,493,18184,1052,"Jones County, Iowa(7,8)",57.8,17,"Jones County, Iowa",36.6,11,stable,20466,19,105,36.6,57.8
IA,"Keokuk County, Iowa",1374,613,761,19107,43838,44524,NA,NA,NA,29063,4763,393,4784,228,9547,621,"Keokuk County, Iowa(7,8)",68.1,10,"Keokuk County, Iowa",55.1,9,stable,10163,19,107,55.1,68.1
IA,"Kossuth County, Iowa",1357,532,825,19109,51496,51899,NA,NA,NA,26174,7112,425,7158,327,14270,752,"Kossuth County, Iowa(7,8)",58,14,"Kossuth County, Iowa",41.4,10,stable,15165,19,109,41.4,58
IA,"Lee County, Iowa",5791,2606,3185,19111,43312,43871,31953,NA,53654,35068,15554,1813,15861,1472,31415,3285,"Lee County, Iowa(7,8)",73.2,36,"Lee County, Iowa",59.7,30,stable,35089,19,111,59.7,73.2
IA,"Linn County, Iowa",20747,9853,10894,19113,59322,60826,26900,40052,75086,35469,98672,7125,102735,6117,201407,13242,"Linn County, Iowa(7,8)",65.7,152,"Linn County, Iowa",47.6,110,falling,219916,19,113,47.6,65.7
IA,"Louisa County, Iowa",1357,589,768,19115,51144,52341,36023,NA,34712,48667,5331,366,5018,426,10349,792,"Louisa County, Iowa(7,8)",64.1,9,"Louisa County, Iowa",44.9,6,stable,11185,19,115,44.9,64.1
IA,"Lucas County, Iowa",1126,596,530,19117,43962,44635,NA,NA,NA,NA,3889,436,3961,312,7850,748,"Lucas County, Iowa(7,8)",60.1,8,"Lucas County, Iowa",44.5,6,stable,8682,19,117,44.5,60.1
IA,"Lyon County, Iowa",843,404,439,19119,57130,56956,NA,145750,NA,77857,5292,567,5245,449,10537,1016,"Lyon County, Iowa(7,8)",45.2,7,"Lyon County, Iowa",24.4,3,**,11745,19,119,24.4,45.2
IA,"Madison County, Iowa",1164,567,597,19121,60060,60226,NA,NA,44076,NA,7185,541,7336,395,14521,936,"Madison County, Iowa(7,8)",58.2,11,"Madison County, Iowa",40.4,8,stable,15753,19,121,40.4,58.2
IA,"Mahaska County, Iowa",3206,1330,1876,19123,48726,49339,43088,47857,53000,34083,10334,800,10558,470,20892,1270,"Mahaska County, Iowa(7,8)",79.1,22,"Mahaska County, Iowa",66.6,19,rising,22324,19,123,66.6,79.1
IA,"Marion County, Iowa",3124,1459,1665,19125,54693,54672,41250,NA,77054,35640,15729,734,15889,647,31618,1381,"Marion County, Iowa(7,8)",57.4,24,"Marion County, Iowa",43.6,18,stable,33294,19,125,43.6,57.4
IA,"Marshall County, Iowa",4429,2268,2161,19127,53351,54565,39167,NA,54458,46698,18265,1919,18398,1389,36663,3308,"Marshall County, Iowa(7,8)",65.8,35,"Marshall County, Iowa",49.3,27,falling,40746,19,127,49.3,65.8
IA,"Mills County, Iowa",1300,667,633,19129,63979,64583,2499,8920,NA,117740,6865,528,6811,418,13676,946,"Mills County, Iowa(7,8)",73.1,13,"Mills County, Iowa",49.1,9,stable,14844,19,129,49.1,73.1
IA,"Mitchell County, Iowa",1005,476,529,19131,49488,49426,NA,NA,NA,NA,4662,625,4802,456,9464,1081,"Mitchell County, Iowa(7,8)",48.2,9,"Mitchell County, Iowa",24.8,5,falling,10832,19,131,24.8,48.2
IA,"Monona County, Iowa",1233,529,704,19133,40302,40632,NA,NA,NA,81146,4113,336,4084,343,8197,679,"Monona County, Iowa(7,8)",58.3,9,"Monona County, Iowa",46.6,8,stable,8979,19,133,46.6,58.3
IA,"Monroe County, Iowa",944,348,596,19135,46304,46424,NA,NA,NA,NA,3490,602,3357,417,6847,1019,"Monroe County, Iowa(7,8)",74.8,9,"Monroe County, Iowa",71.3,8,stable,7973,19,135,71.3,74.8
IA,"Montgomery County, Iowa",1717,715,1002,19137,42418,43214,NA,NA,NA,24792,4447,518,4980,327,9427,845,"Montgomery County, Iowa(7,8)",59,10,"Montgomery County, Iowa",50.8,8,stable,10234,19,137,50.8,59
IA,"Muscatine County, Iowa",5219,2406,2813,19139,53676,54315,21761,96352,85489,42368,19539,1665,19543,1683,39082,3348,"Muscatine County, Iowa(7,8)",62.8,31,"Muscatine County, Iowa",48.4,23,stable,43011,19,139,48.4,62.8
IA,"O'Brien County, Iowa",1013,473,540,19141,55227,56469,NA,NA,91023,33364,6514,472,6423,477,12937,949,"O'Brien County, Iowa(7,8)",53.2,12,"O'Brien County, Iowa",39.3,9,stable,13984,19,141,39.3,53.2
IA,"Osceola County, Iowa",521,192,329,19143,49448,49140,NA,NA,NA,54327,2812,263,2737,295,5549,558,"Osceola County, Iowa(7,8)",52.1,5,"Osceola County, Iowa",47.2,5,**,6154,19,143,47.2,52.1
IA,"Page County, Iowa",2262,1116,1146,19145,43912,43918,NA,NA,112917,NA,6505,822,6810,597,13315,1419,"Page County, Iowa(7,8)",98,23,"Page County, Iowa",50.1,12,stable,15527,19,145,50.1,98
IA,"Palo Alto County, Iowa",948,421,527,19147,47113,47188,47054,NA,60568,35714,4213,355,4197,240,8410,595,"Palo Alto County, Iowa(7,8)",61.1,9,"Palo Alto County, Iowa",35.2,5,stable,9133,19,147,35.2,61.1
IA,"Plymouth County, Iowa",1907,817,1090,19149,57130,57495,NA,NA,NA,27143,11390,766,11769,636,23159,1402,"Plymouth County, Iowa(7,8)",54.9,18,"Plymouth County, Iowa",40.6,14,stable,24800,19,149,40.6,54.9
IA,"Pocahontas County, Iowa",987,458,529,19151,45069,45714,22708,NA,NA,41875,3169,326,3264,208,6433,534,"Pocahontas County, Iowa(7,8)",52.4,6,"Pocahontas County, Iowa",35.5,5,stable,7008,19,151,35.5,52.4
IA,"Polk County, Iowa",57143,25452,31691,19153,60061,62351,29164,22955,64090,41624,202694,17295,213559,13896,416253,31191,"Polk County, Iowa(7,8)",75.3,309,"Polk County, Iowa",57.2,233,falling,467711,19,153,57.2,75.3
IA,"Pottawattamie County, Iowa",11779,5050,6729,19155,51976,52119,NA,NA,64455,42234,40374,4897,43002,3788,83376,8685,"Pottawattamie County, Iowa(7,8)",84.6,94,"Pottawattamie County, Iowa",61.5,68,stable,93671,19,155,61.5,84.6
IA,"Poweshiek County, Iowa",1767,731,1036,19157,51006,51119,NA,NA,NA,NA,8281,576,8937,594,17218,1170,"Poweshiek County, Iowa(7,8)",43.4,12,"Poweshiek County, Iowa",31.8,9,stable,18550,19,157,31.8,43.4
IA,"Ringgold County, Iowa",514,206,308,19159,47042,47167,NA,NA,NA,NA,2148,282,2171,273,4319,555,"Ringgold County, Iowa(7)",46.1,4,"Ringgold County, Iowa",41.2,4,stable,5068,19,159,41.2,46.1
IA,"Sac County, Iowa",805,304,501,19161,49572,49615,54583,NA,NA,37969,4568,358,4657,324,9225,682,"Sac County, Iowa(7,8)",57.4,10,"Sac County, Iowa",37.7,6,stable,10021,19,161,37.7,57.4
IA,"Scott County, Iowa",20229,8767,11462,19163,55114,56953,32865,33056,67068,47304,74793,7742,80096,5650,154889,13392,"Scott County, Iowa(7,8)",72.7,134,"Scott County, Iowa",53.2,99,stable,172126,19,163,53.2,72.7
IA,"Shelby County, Iowa",1307,600,707,19165,50952,50645,NA,NA,NA,63692,5277,539,5582,372,10859,911,"Shelby County, Iowa(7,8)",52.4,10,"Shelby County, Iowa",37,7,stable,11927,19,165,37,52.4
IA,"Sioux County, Iowa",2663,1099,1564,19167,61627,62970,NA,NA,NA,36610,15807,1411,15737,1129,31544,2540,"Sioux County, Iowa(7,8)",43.1,16,"Sioux County, Iowa",33.9,13,stable,34937,19,167,33.9,43.1
IA,"Story County, Iowa",19109,10045,9064,19169,50438,52279,NA,NA,21900,31179,45559,2642,42773,1887,88332,4529,"Story County, Iowa(7,8)",56,43,"Story County, Iowa",41,32,stable,96021,19,169,41,56
IA,"Tama County, Iowa",1919,903,1016,19171,55203,55770,45694,41625,NA,57292,7763,735,7896,704,15659,1439,"Tama County, Iowa(7,8)",65.3,16,"Tama County, Iowa",39.3,10,stable,17337,19,171,39.3,65.3
IA,"Taylor County, Iowa",860,386,474,19173,44246,45298,NA,NA,NA,26000,2683,396,2720,312,5403,708,"Taylor County, Iowa(7,8)",57.9,6,"Taylor County, Iowa",52.7,5,stable,6205,19,173,52.7,57.9
IA,"Union County, Iowa",1676,669,1007,19175,44351,44797,NA,NA,NA,NA,5477,483,5890,585,11367,1068,"Union County, Iowa(7,8)",74.3,13,"Union County, Iowa",56.5,10,stable,12469,19,175,56.5,74.3
IA,"Van Buren County, Iowa",1095,545,550,19177,45111,45472,NA,NA,NA,26346,3256,524,3112,473,6368,997,"Van Buren County, Iowa(7,8)",75.4,9,"Van Buren County, Iowa",52.4,6,stable,7344,19,177,52.4,75.4
IA,"Wapello County, Iowa",6399,3090,3309,19179,42095,42455,21957,43125,57000,47212,15390,1800,16210,1526,31600,3326,"Wapello County, Iowa(7,8)",78.5,36,"Wapello County, Iowa",55.5,25,stable,35173,19,179,55.5,78.5
IA,"Warren County, Iowa",3124,1413,1711,19181,64447,64813,56653,NA,NA,41273,21891,1175,22863,1028,44754,2203,"Warren County, Iowa(7,8)",69.5,37,"Warren County, Iowa",48.4,25,stable,48626,19,181,48.4,69.5
IA,"Washington County, Iowa",2013,883,1130,19183,56390,57218,40833,NA,NA,37241,9615,1082,9902,1095,19517,2177,"Washington County, Iowa(7,8)",52.9,16,"Washington County, Iowa",39.6,12,stable,22247,19,183,39.6,52.9
IA,"Wayne County, Iowa",834,372,462,19185,43358,43535,NA,NA,NA,NA,2650,385,2814,433,5464,818,"Wayne County, Iowa(7,8)",63.7,6,"Wayne County, Iowa",41.2,4,stable,6385,19,185,41.2,63.7
IA,"Webster County, Iowa",5210,2122,3088,19187,42408,42477,NA,NA,72831,NA,15924,1780,16616,1216,32540,2996,"Webster County, Iowa(7,8)",67.6,34,"Webster County, Iowa",46,23,falling,37071,19,187,46,67.6
IA,"Winnebago County, Iowa",995,465,530,19189,47668,47878,NA,NA,69306,NA,4821,308,5032,234,9853,542,"Winnebago County, Iowa(7,8)",61.3,10,"Winnebago County, Iowa",51.5,8,rising,10609,19,189,51.5,61.3
IA,"Winneshiek County, Iowa",1507,676,831,19191,54429,54119,NA,14375,NA,NA,9724,563,9833,484,19557,1047,"Winneshiek County, Iowa(7,8)",36,10,"Winneshiek County, Iowa",22.2,7,stable,20709,19,191,22.2,36
IA,"Woodbury County, Iowa",14557,6122,8435,19193,46720,47648,38203,22465,47180,37347,43575,6383,47044,4576,90619,10959,"Woodbury County, Iowa(7,8)",71.5,79,"Woodbury County, Iowa",51.5,57,stable,102782,19,193,51.5,71.5
IA,"Worth County, Iowa",887,389,498,19195,48459,49419,2499,NA,NA,15625,3395,305,3519,243,6914,548,"Worth County, Iowa(7,8)",45.3,5,"Worth County, Iowa",30.7,4,stable,7569,19,195,30.7,45.3
IA,"Wright County, Iowa",1412,649,763,19197,43698,44444,NA,NA,250001,38850,5785,580,5903,489,11688,1069,"Wright County, Iowa(7,8)",56.1,12,"Wright County, Iowa",40.3,9,stable,12773,19,197,40.3,56.1
ID,"Ada County, Idaho",50551,24218,26333,16001,56356,57008,48844,34688,67771,45457,179687,24140,186069,21581,365756,45721,"Ada County, Idaho(6,10)",52.2,191,"Ada County, Idaho",37.6,136,falling,434211,16,1,37.6,52.2
ID,"Adams County, Idaho",495,261,234,16003,39565,40120,NA,NA,NA,NA,1685,338,1408,417,3093,755,"Adams County, Idaho(6,10)",69.5,5,"Adams County, Idaho",*,*,**,3843,16,3,NA,69.5
ID,"Bannock County, Idaho",15288,7053,8235,16005,43779,44300,NA,42500,50472,38198,35907,5326,35846,5215,71753,10541,"Bannock County, Idaho(6,10)",41,32,"Bannock County, Idaho",32.5,25,falling,83744,16,5,32.5,41
ID,"Bear Lake County, Idaho",759,352,407,16007,48654,48600,NA,NA,NA,73750,2602,372,2618,308,5220,680,"Bear Lake County, Idaho(6,10)",*,3 or fewer,"Bear Lake County, Idaho",*,*,**,5922,16,7,NA,NA
ID,"Benewah County, Idaho",1490,695,795,16009,39863,40818,NA,33625,71198,43125,3578,964,3616,844,7194,1808,"Benewah County, Idaho(6,10)",79,10,"Benewah County, Idaho",67.7,9,stable,9052,16,9,67.7,79
ID,"Bingham County, Idaho",6093,2801,3292,16011,50155,51519,NA,27000,52708,45245,19203,3329,19504,3105,38707,6434,"Bingham County, Idaho(6,10)",38.7,18,"Bingham County, Idaho",31.9,15,stable,44990,16,11,31.9,38.7
ID,"Blaine County, Idaho",2218,989,1229,16013,60088,60597,NA,NA,60324,40645,8753,2073,9000,1457,17753,3530,"Blaine County, Idaho(6,10)",22.6,5,"Blaine County, Idaho",*,*,*,21592,16,13,NA,22.6
ID,"Boise County, Idaho",991,490,501,16015,44238,44167,NA,36250,NA,63333,3004,611,2874,368,5878,979,"Boise County, Idaho(6,10)",69.2,6,"Boise County, Idaho",38.3,3,**,7058,16,15,38.3,69.2
ID,"Bonner County, Idaho",6145,2946,3199,16017,42171,42215,NA,NA,2499,54464,16871,3473,17198,3180,34069,6653,"Bonner County, Idaho(6,10)",54.3,32,"Bonner County, Idaho",43.7,26,falling,41859,16,17,43.7,54.3
ID,"Bonneville County, Idaho",14025,6101,7924,16019,50762,51682,NA,24797,50469,36851,45074,7432,47260,6823,92334,14255,"Bonneville County, Idaho(6,10)",35.7,35,"Bonneville County, Idaho",25.4,24,stable,110089,16,19,25.4,35.7
ID,"Boundary County, Idaho",1647,774,873,16021,38961,38078,NA,51029,NA,63448,4380,1173,3939,1397,8319,2570,"Boundary County, Idaho(6,10)",46.3,7,"Boundary County, Idaho",35.4,5,stable,11318,16,21,35.4,46.3
ID,"Butte County, Idaho",460,241,219,16023,37891,38984,NA,NA,NA,26823,1191,221,978,226,2169,447,"Butte County, Idaho(6,10)",*,3 or fewer,"Butte County, Idaho",*,*,**,2501,16,23,NA,NA
ID,"Camas County, Idaho",229,101,128,16025,42614,42614,NA,NA,NA,NA,421,117,386,128,807,245,"Camas County, Idaho(6,10)",*,3 or fewer,"Camas County, Idaho",*,*,**,1066,16,25,NA,NA
ID,"Canyon County, Idaho",37945,17283,20662,16027,42888,43191,30799,31431,60449,36336,79546,18096,82935,16843,162481,34939,"Canyon County, Idaho(6,10)",56.1,99,"Canyon County, Idaho",40.8,72,stable,207478,16,27,40.8,56.1
ID,"Caribou County, Idaho",551,215,336,16029,58021,58212,NA,NA,NA,42222,3102,281,3077,258,6179,539,"Caribou County, Idaho(6,10)",*,3 or fewer,"Caribou County, Idaho",*,*,**,6770,16,29,NA,NA
ID,"Cassia County, Idaho",3645,1616,2029,16031,45695,46089,NA,33750,NA,36971,9384,2297,9055,2252,18439,4549,"Cassia County, Idaho(6,10)",34,8,"Cassia County, Idaho",26.9,6,**,23506,16,31,26.9,34
ID,"Clark County, Idaho",163,98,65,16033,33672,34141,NA,NA,NA,26607,231,209,329,132,560,341,"Clark County, Idaho(6,10)",*,3 or fewer,"Clark County, Idaho",*,*,**,880,16,33,NA,NA
ID,"Clearwater County, Idaho",985,423,562,16035,38837,38796,NA,34375,NA,51058,3224,522,3185,591,6409,1113,"Clearwater County, Idaho(6,10)",55.4,8,"Clearwater County, Idaho",40.7,6,stable,8496,16,35,40.7,55.4
ID,"Custer County, Idaho",806,397,409,16037,39457,38876,NA,NA,NA,NA,1931,206,1642,423,3573,629,"Custer County, Idaho(6,10)",52.4,4,"Custer County, Idaho",*,*,**,4087,16,37,NA,52.4
ID,"Elmore County, Idaho",4046,1773,2273,16039,43848,44400,47353,NA,43000,37681,9973,1643,10638,1656,20611,3299,"Elmore County, Idaho(6,10)",72.4,17,"Elmore County, Idaho",59.2,13,stable,25876,16,39,59.2,72.4
ID,"Franklin County, Idaho",1696,773,923,16041,48133,49589,NA,NA,NA,26917,5577,947,5343,1001,10920,1948,"Franklin County, Idaho(6,10)",*,3 or fewer,"Franklin County, Idaho",*,*,**,13074,16,41,NA,NA
ID,"Fremont County, Idaho",1266,601,665,16043,47988,49125,NA,36944,NA,33504,5200,902,5250,990,10450,1892,"Fremont County, Idaho(6,10)",40.4,6,"Fremont County, Idaho",31.7,5,**,12819,16,43,31.7,40.4
ID,"Gem County, Idaho",2980,1404,1576,16045,40828,41617,NA,NA,NA,25786,6654,1658,6630,1648,13284,3306,"Gem County, Idaho(6,10)",67.1,17,"Gem County, Idaho",51,13,stable,16852,16,45,51,67.1
ID,"Gooding County, Idaho",2911,1593,1318,16047,39930,42500,NA,33313,NA,34653,5885,1938,5746,1581,11631,3519,"Gooding County, Idaho(6,10)",66.9,12,"Gooding County, Idaho",43.7,8,stable,15284,16,47,43.7,66.9
ID,"Idaho County, Idaho",2528,1219,1309,16049,38191,38700,NA,20950,NA,47841,6967,1125,6473,1223,13440,2348,"Idaho County, Idaho(6,10)",48.2,14,"Idaho County, Idaho",36.3,10,stable,16272,16,49,36.3,48.2
ID,"Jefferson County, Idaho",3492,1558,1934,16051,51171,51748,NA,NA,NA,36115,11265,2219,11699,1550,22964,3769,"Jefferson County, Idaho(6,10)",33.9,7,"Jefferson County, Idaho",31.2,7,**,27157,16,51,31.2,33.9
ID,"Jerome County, Idaho",3676,1577,2099,16053,41630,42237,NA,39602,NA,34464,8327,3044,8345,2816,16672,5860,"Jerome County, Idaho(6,10)",48,10,"Jerome County, Idaho",35.8,7,stable,22814,16,53,35.8,48
ID,"Kootenai County, Idaho",18634,8293,10341,16055,49403,49872,NA,37239,40000,52289,59838,11075,61963,10877,121801,21952,"Kootenai County, Idaho(6,10)",56.6,96,"Kootenai County, Idaho",41.2,69,falling,150346,16,55,41.2,56.6
ID,"Latah County, Idaho",7597,3909,3688,16057,42439,43394,16950,NA,NA,NA,17900,1704,16876,1693,34776,3397,"Latah County, Idaho(6,10)",50.6,17,"Latah County, Idaho",37.2,12,stable,38778,16,57,37.2,50.6
ID,"Lemhi County, Idaho",1430,657,773,16059,34329,33897,NA,60083,NA,NA,3298,602,3193,606,6491,1208,"Lemhi County, Idaho(6,10)",46.5,7,"Lemhi County, Idaho",40.6,6,stable,7735,16,59,40.6,46.5
ID,"Lewis County, Idaho",652,251,401,16061,36505,36378,NA,53750,NA,33250,1484,347,1502,425,2986,772,"Lewis County, Idaho(6,10)",66.5,4,"Lewis County, Idaho",*,*,**,3789,16,61,NA,66.5
ID,"Lincoln County, Idaho",709,341,368,16063,43273,43935,NA,NA,NA,44732,1942,723,1969,587,3911,1310,"Lincoln County, Idaho(6,10)",*,3 or fewer,"Lincoln County, Idaho",*,*,**,5297,16,63,NA,NA
ID,"Madison County, Idaho",13232,6357,6875,16065,32233,32276,NA,NA,60673,27012,16867,2083,17065,1700,33932,3783,"Madison County, Idaho(6,10)",*,3 or fewer,"Madison County, Idaho",*,*,**,38273,16,65,NA,NA
ID,"Minidoka County, Idaho",3501,1562,1939,16067,44853,45534,17875,NA,64583,37571,7661,2570,7775,2174,15436,4744,"Minidoka County, Idaho(6,10)",54.8,13,"Minidoka County, Idaho",38.1,9,stable,20461,16,67,38.1,54.8
ID,"Nez Perce County, Idaho",4581,2166,2415,16069,48160,48169,143056,53487,NA,26844,16662,2619,17470,2343,34132,4962,"Nez Perce County, Idaho(6,10)",69.3,38,"Nez Perce County, Idaho",54,30,stable,40048,16,69,54,69.3
ID,"Oneida County, Idaho",615,292,323,16071,41338,41937,NA,NA,NA,31354,1951,229,1800,232,3751,461,"Oneida County, Idaho(6,10)",*,3 or fewer,"Oneida County, Idaho",*,*,**,4281,16,71,NA,NA
ID,"Owyhee County, Idaho",3091,1580,1511,16073,33440,34906,NA,27625,NA,25223,4083,1696,4060,1385,8143,3081,"Owyhee County, Idaho(6,10)",40.7,5,"Owyhee County, Idaho",48.9,6,**,11310,16,73,48.9,40.7
ID,"Payette County, Idaho",4152,1963,2189,16075,44257,44736,NA,41875,NA,39359,9157,2205,8899,2287,18056,4492,"Payette County, Idaho(6,10)",64.8,18,"Payette County, Idaho",40.3,11,stable,22896,16,75,40.3,64.8
ID,"Power County, Idaho",1034,353,681,16077,44779,43551,NA,56186,NA,40921,3396,471,3203,596,6599,1067,"Power County, Idaho(6,10)",41.4,3,"Power County, Idaho",*,*,**,7648,16,77,NA,41.4
ID,"Shoshone County, Idaho",2108,1006,1102,16079,37665,37877,NA,NA,NA,NA,5282,950,5050,1088,10332,2038,"Shoshone County, Idaho(6,10)",98.7,20,"Shoshone County, Idaho",74.8,15,stable,12432,16,79,74.8,98.7
ID,"Teton County, Idaho",1110,441,669,16081,53474,53775,NA,NA,NA,41406,4354,1025,3953,953,8307,1978,"Teton County, Idaho(6,10)",*,3 or fewer,"Teton County, Idaho",*,*,**,10564,16,81,NA,NA
ID,"Twin Falls County, Idaho",12418,5566,6852,16083,44048,45438,39915,25325,34745,34527,31896,7143,33910,6119,65806,13262,"Twin Falls County, Idaho(6,10)",53.4,47,"Twin Falls County, Idaho",42,37,stable,82375,16,83,42,53.4
ID,"Valley County, Idaho",1434,857,577,16085,48384,48796,NA,NA,NA,NA,3987,1012,3991,647,7978,1659,"Valley County, Idaho(6,10)",41.3,6,"Valley County, Idaho",27.8,4,stable,10103,16,85,27.8,41.3
ID,"Washington County, Idaho",1798,886,912,16087,34775,35000,NA,NA,26875,26080,4079,918,3849,1041,7928,1959,"Washington County, Idaho(6,10)",68.3,11,"Washington County, Idaho",54.4,8,stable,9984,16,87,54.4,68.3
IL,"Adams County, Illinois",9433,4259,5174,17001,45965,46776,23646,15859,49891,60764,28948,3173,31295,2375,60243,5548,"Adams County, Illinois(6,10)",74.1,68,"Adams County, Illinois",50.8,48,falling,67013,17,1,50.8,74.1
IL,"Alexander County, Illinois",2424,1018,1406,17003,27265,34142,17166,NA,58750,28333,2784,619,3204,517,5988,1136,"Alexander County, Illinois(6,10)",93.5,11,"Alexander County, Illinois",66,7,stable,6780,17,3,66,93.5
IL,"Bond County, Illinois",2593,1121,1472,17005,47946,48504,45000,NA,NA,NA,7306,520,8056,347,15362,867,"Bond County, Illinois(6,10)",70.2,15,"Bond County, Illinois",47,10,stable,16950,17,5,47,70.2
IL,"Boone County, Illinois",5841,2237,3604,17007,58248,57416,56845,103669,119256,52413,24063,2679,24223,2568,48286,5247,"Boone County, Illinois(6,10)",66.3,36,"Boone County, Illinois",52.8,28,stable,53585,17,7,52.8,66.3
IL,"Brown County, Illinois",565,305,260,17009,50739,50493,NA,NA,NA,NA,2570,194,2292,135,4862,329,"Brown County, Illinois(6,10)",81.4,6,"Brown County, Illinois",46.6,3,**,6829,17,9,46.6,81.4
IL,"Bureau County, Illinois",4191,1800,2391,17011,50423,50351,50709,NA,52431,42069,14846,1743,15866,1269,30712,3012,"Bureau County, Illinois(6,10)",69.6,34,"Bureau County, Illinois",50.4,25,stable,33587,17,11,50.4,69.6
IL,"Calhoun County, Illinois",606,294,312,17013,53869,55147,NA,NA,NA,NA,2333,147,2349,90,4682,237,"Calhoun County, Illinois(6,10)",81.4,6,"Calhoun County, Illinois",47.8,4,**,4899,17,13,47.8,81.4
IL,"Carroll County, Illinois",1843,894,949,17015,48631,48888,NA,NA,53750,48125,6529,829,6845,546,13374,1375,"Carroll County, Illinois(6,10)",54,14,"Carroll County, Illinois",47.4,12,stable,14616,17,15,47.4,54
IL,"Cass County, Illinois",1688,775,913,17017,47434,49527,35515,NA,NA,36659,6014,693,5811,576,11825,1269,"Cass County, Illinois(6,10)",89.7,15,"Cass County, Illinois",72.4,12,stable,12847,17,17,72.4,89.7
IL,"Champaign County, Illinois",43284,21117,22167,17019,46495,52629,25921,47560,24601,36684,92122,9537,95737,6476,187859,16013,"Champaign County, Illinois(6,10)",62.4,107,"Champaign County, Illinois",42.4,73,falling,208861,17,19,42.4,62.4
IL,"Christian County, Illinois",4714,1953,2761,17021,45334,45615,15536,NA,NA,65586,14242,1622,15615,940,29857,2562,"Christian County, Illinois(6,10)",94.1,45,"Christian County, Illinois",69.2,33,stable,33642,17,21,69.2,94.1
IL,"Clark County, Illinois",2360,995,1365,17023,50517,50382,NA,NA,NA,2499,6969,759,7522,678,14491,1437,"Clark County, Illinois(6,10)",75.5,17,"Clark County, Illinois",56.1,13,stable,15979,17,23,56.1,75.5
IL,"Clay County, Illinois",1839,719,1120,17025,44209,44224,NA,37917,NA,56094,5900,719,6221,566,12121,1285,"Clay County, Illinois(6,10)",79.5,15,"Clay County, Illinois",55.8,11,stable,13428,17,25,55.8,79.5
IL,"Clinton County, Illinois",3193,1251,1942,17027,63236,64114,NA,9150,NA,75184,16679,1061,17243,1018,33922,2079,"Clinton County, Illinois(6,10)",63.6,29,"Clinton County, Illinois",43.9,20,falling,37786,17,27,43.9,63.6
IL,"Coles County, Illinois",10951,4833,6118,17029,39588,40775,15673,NA,NA,NA,22166,3037,25035,2111,47201,5148,"Coles County, Illinois(6,10)",80.4,48,"Coles County, Illinois",56.1,34,stable,52521,17,29,56.1,80.4
IL,"Cook County, Illinois",879499,392713,486786,17031,55251,65946,34289,42309,70485,45366,2103599,410838,2348142,330018,4451741,740856,"Cook County, Illinois(6,10)",63.4,3359,"Cook County, Illinois",44.7,"2,369",falling,5238216,17,31,44.7,63.4
IL,"Crawford County, Illinois",2310,1127,1183,17033,47468,47670,101346,2499,81181,14655,7860,1003,8562,736,16422,1739,"Crawford County, Illinois(6,10)",88.9,24,"Crawford County, Illinois",55.5,15,stable,19414,17,33,55.5,88.9
IL,"Cumberland County, Illinois",1700,755,945,17035,46061,46414,NA,NA,2499,26250,5052,410,5011,344,10063,754,"Cumberland County, Illinois(6,10)",89.1,13,"Cumberland County, Illinois",62.6,9,stable,10898,17,35,62.6,89.1
IL,"DeKalb County, Illinois",18336,7881,10455,17037,54101,57900,21072,NA,38824,41786,45996,5120,47894,4510,93890,9630,"DeKalb County, Illinois(6,10)",72.8,63,"DeKalb County, Illinois",46.2,40,stable,104352,17,37,46.2,72.8
IL,"De Witt County, Illinois",2073,936,1137,17039,53959,54467,NA,107917,NA,31466,7261,845,7595,448,14856,1293,"De Witt County, Illinois(6,10)",94.3,21,"De Witt County, Illinois",78.1,17,stable,16247,17,39,78.1,94.3
IL,"Douglas County, Illinois",2019,829,1190,17041,51810,51974,NA,49000,NA,41985,7827,1829,8266,1748,16093,3577,"Douglas County, Illinois(6,10)",66.3,17,"Douglas County, Illinois",46.2,12,stable,19823,17,41,46.2,66.3
IL,"DuPage County, Illinois",67941,30099,37842,17043,79658,81187,51329,55500,95020,58347,411862,42255,435524,34940,847386,77195,"DuPage County, Illinois(6,10)",56.1,529,"DuPage County, Illinois",38.7,362,falling,933736,17,43,38.7,56.1
IL,"Edgar County, Illinois",2999,1370,1629,17045,45691,45755,NA,NA,60625,NA,7988,698,8274,762,16262,1460,"Edgar County, Illinois(6,10)",76.6,20,"Edgar County, Illinois",59.7,16,stable,17664,17,45,59.7,76.6
IL,"Edwards County, Illinois",851,364,487,17047,44497,44549,NA,NA,NA,2499,2924,344,3146,201,6070,545,"Edwards County, Illinois(6,10)",88.7,9,"Edwards County, Illinois",60.7,6,stable,6534,17,47,60.7,88.7
IL,"Effingham County, Illinois",3557,1758,1799,17049,52224,52243,NA,NA,65435,48125,15617,1332,15938,1040,31555,2372,"Effingham County, Illinois(6,10)",67.5,29,"Effingham County, Illinois",45.2,19,stable,34371,17,49,45.2,67.5
IL,"Fayette County, Illinois",3644,1651,1993,17051,43944,44007,NA,NA,NA,NA,8549,1573,9305,1070,17854,2643,"Fayette County, Illinois(6,10)",58,16,"Fayette County, Illinois",43.7,13,stable,22043,17,51,43.7,58
IL,"Ford County, Illinois",1790,792,998,17053,49947,49681,88077,55089,NA,43452,5896,759,6325,444,12221,1203,"Ford County, Illinois(6,10)",66.8,14,"Ford County, Illinois",48.3,11,stable,13736,17,53,48.3,66.8
IL,"Franklin County, Illinois",7191,3279,3912,17055,39512,39761,41042,19191,31875,33125,17019,2304,17973,1920,34992,4224,"Franklin County, Illinois(6,10)",103.4,59,"Franklin County, Illinois",73.7,42,stable,39485,17,55,73.7,103.4
IL,"Fulton County, Illinois",4838,2193,2645,17057,46083,45967,NA,NA,21250,NA,15208,1655,16087,1139,31295,2794,"Fulton County, Illinois(6,10)",74.9,38,"Fulton County, Illinois",54.2,28,stable,35699,17,57,54.2,74.9
IL,"Gallatin County, Illinois",837,375,462,17059,39636,40133,NA,NA,NA,NA,2279,291,2598,217,4877,508,"Gallatin County, Illinois(6,10)",87.9,8,"Gallatin County, Illinois",74.1,7,stable,5265,17,59,74.1,87.9
IL,"Greene County, Illinois",2231,994,1237,17061,42565,42773,NA,NA,NA,NA,5958,630,6055,601,12013,1231,"Greene County, Illinois(6,10)",72.7,14,"Greene County, Illinois",55.7,11,stable,13241,17,61,55.7,72.7
IL,"Grundy County, Illinois",4531,1897,2634,17063,65887,67212,30743,NA,NA,56676,23054,1929,23379,1691,46433,3620,"Grundy County, Illinois(6,10)",90,45,"Grundy County, Illinois",55.3,28,stable,50541,17,63,55.3,90
IL,"Hamilton County, Illinois",1211,565,646,17065,44159,44159,NA,NA,NA,NA,3633,433,3779,396,7412,829,"Hamilton County, Illinois(6,10)",85.2,11,"Hamilton County, Illinois",80.2,10,stable,8200,17,65,80.2,85.2
IL,"Hancock County, Illinois",2159,950,1209,17067,47699,48171,NA,26250,40250,NA,8424,750,8769,629,17193,1379,"Hancock County, Illinois(6,10)",74.4,21,"Hancock County, Illinois",54.9,16,stable,18543,17,67,54.9,74.4
IL,"Hardin County, Illinois",864,355,509,17069,38838,38596,NA,NA,91250,NA,1854,295,1872,172,3726,467,"Hardin County, Illinois(6,10)",90.3,6,"Hardin County, Illinois",57.4,4,stable,4135,17,69,57.4,90.3
IL,"Henderson County, Illinois",692,230,462,17071,47672,47672,NA,NA,NA,NA,3131,263,3331,252,6462,515,"Henderson County, Illinois(6,10)",78.2,9,"Henderson County, Illinois",62.3,7,stable,6995,17,71,62.3,78.2
IL,"Henry County, Illinois",5256,2166,3090,17073,53480,54257,17679,NA,56544,38589,22242,2034,23560,1281,45802,3315,"Henry County, Illinois(6,10)",74.9,52,"Henry County, Illinois",57.1,40,stable,49489,17,73,57.1,74.9
IL,"Iroquois County, Illinois",4735,2010,2725,17075,47834,48692,21378,NA,48125,37167,12646,1403,13538,1009,26184,2412,"Iroquois County, Illinois(6,10)",72,31,"Iroquois County, Illinois",52,23,falling,28672,17,75,52,72
IL,"Jackson County, Illinois",16853,8533,8320,17077,33871,38689,15280,22578,32132,20517,26309,3171,27085,2267,53394,5438,"Jackson County, Illinois(6,10)",69,41,"Jackson County, Illinois",47.2,28,stable,59362,17,77,47.2,69
IL,"Jasper County, Illinois",881,319,562,17079,54209,54238,NA,NA,NA,NA,4354,425,4455,338,8809,763,"Jasper County, Illinois(6,10)",67.3,9,"Jasper County, Illinois",64.3,8,stable,9607,17,79,64.3,67.3
IL,"Jefferson County, Illinois",6179,2740,3439,17081,43247,44648,31696,NA,72798,36042,16146,1840,16917,1633,33063,3473,"Jefferson County, Illinois(6,10)",92.7,46,"Jefferson County, Illinois",68.7,34,stable,38353,17,81,68.7,92.7
IL,"Jersey County, Illinois",1590,559,1031,17083,53271,53261,NA,NA,NA,61314,9880,1023,10390,988,20270,2011,"Jersey County, Illinois(6,10)",78.7,23,"Jersey County, Illinois",62.3,19,stable,22372,17,83,62.3,78.7
IL,"Jo Daviess County, Illinois",2032,849,1183,17085,53221,53160,NA,NA,120000,36224,10402,789,10313,741,20715,1530,"Jo Daviess County, Illinois(6,10)",55.9,22,"Jo Daviess County, Illinois",44.8,17,stable,22086,17,85,44.8,55.9
IL,"Johnson County, Illinois",1589,761,828,17087,42287,42559,NA,NA,NA,42500,4825,579,5104,431,9929,1010,"Johnson County, Illinois(6,10)",83.6,15,"Johnson County, Illinois",60.5,10,stable,12762,17,87,60.5,83.6
IL,"Kane County, Illinois",59033,26663,32370,17089,70696,77290,39620,36705,92529,49138,224538,34989,234737,27421,459275,62410,"Kane County, Illinois(6,10)",58.9,266,"Kane County, Illinois",43.7,193,falling,530847,17,89,43.7,58.9
IL,"Kankakee County, Illinois",17365,7945,9420,17091,52110,56820,28198,40823,71389,42650,47095,6334,52251,4214,99346,10548,"Kankakee County, Illinois(6,10)",73.6,94,"Kankakee County, Illinois",55.1,70,falling,110879,17,91,55.1,73.6
IL,"Kendall County, Illinois",6616,2622,3994,17093,84385,86339,83685,NA,90037,62889,55861,3639,57763,2523,113624,6162,"Kendall County, Illinois(6,10)",54.6,45,"Kendall County, Illinois",39.3,32,stable,123355,17,93,39.3,54.6
IL,"Knox County, Illinois",9013,4050,4963,17095,39976,41632,18852,NA,NA,31809,21329,2604,23479,1962,44808,4566,"Knox County, Illinois(6,10)",69.1,53,"Knox County, Illinois",52.5,40,stable,51441,17,95,52.5,69.1
IL,"Lake County, Illinois",65728,30540,35188,17097,78026,80823,39812,54583,102820,49365,300937,38450,317800,30477,618737,68927,"Lake County, Illinois(6,10)",58.2,379,"Lake County, Illinois",40.1,257,falling,703910,17,97,40.1,58.2
IL,"LaSalle County, Illinois",14386,6252,8134,17099,50633,51022,31082,NA,65625,46320,48455,5875,50956,4462,99411,10337,"La Salle County, Illinois(6,10)",76.4,113,"La Salle County, Illinois",56.5,84,falling,111333,17,99,56.5,76.4
IL,"Lawrence County, Illinois",1509,549,960,17101,40841,41069,60500,NA,NA,53150,4119,444,6007,591,10126,1035,"Lawrence County, Illinois(6,10)",88.2,19,"Lawrence County, Illinois",66.4,14,stable,16491,17,101,66.4,88.2
IL,"Lee County, Illinois",3555,1680,1875,17103,52379,52653,61250,23512,NA,40625,14529,1484,14968,1281,29497,2765,"Lee County, Illinois(6,10)",66.9,31,"Lee County, Illinois",53.2,25,stable,34584,17,103,53.2,66.9
IL,"Livingston County, Illinois",3897,1699,2198,17105,54254,54268,NA,NA,NA,35000,15541,1274,15881,997,31422,2271,"Livingston County, Illinois(6,10)",81.6,40,"Livingston County, Illinois",49.7,25,stable,36671,17,105,49.7,81.6
IL,"Logan County, Illinois",3303,1336,1967,17107,50539,53480,16318,66094,49565,56908,10390,973,11924,710,22314,1683,"Logan County, Illinois(6,10)",90.7,34,"Logan County, Illinois",52.9,20,stable,29494,17,107,52.9,90.7
IL,"McDonough County, Illinois",6394,2743,3651,17109,40314,40744,NA,31071,46544,NA,14128,1315,15125,1068,29253,2383,"McDonough County, Illinois(6,10)",63.1,23,"McDonough County, Illinois",50.1,18,stable,31333,17,109,50.1,63.1
IL,"McHenry County, Illinois",24037,11663,12374,17111,77222,77649,68333,55750,95059,57853,139659,12815,142634,10986,282293,23801,"McHenry County, Illinois(6,10)",65.3,185,"McHenry County, Illinois",51.9,143,falling,307343,17,111,51.9,65.3
IL,"McLean County, Illinois",23795,10918,12877,17113,62211,64586,27227,42321,82436,39873,77943,5782,83708,4527,161651,10309,"McLean County, Illinois(6,10)",64.1,97,"McLean County, Illinois",44.7,68,falling,173166,17,113,44.7,64.1
IL,"Macon County, Illinois",19411,8246,11165,17115,47176,51454,21997,NA,73750,47067,45971,5397,51455,3950,97426,9347,"Macon County, Illinois(6,10)",96.6,140,"Macon County, Illinois",62.8,92,stable,107303,17,115,62.8,96.6
IL,"Macoupin County, Illinois",5729,2375,3354,17117,51206,51102,105039,NA,58490,78409,20678,2287,21756,1563,42434,3850,"Macoupin County, Illinois(6,10)",79.5,52,"Macoupin County, Illinois",59.9,39,stable,46045,17,117,59.9,79.5
IL,"Madison County, Illinois",34818,15421,19397,17119,53431,55845,30120,NA,47652,44482,117515,12327,126195,8900,243710,21227,"Madison County, Illinois(6,10)",83.5,265,"Madison County, Illinois",58.5,186,falling,266209,17,119,58.5,83.5
IL,"Marion County, Illinois",6965,3100,3865,17121,42238,43310,30912,13810,62632,23571,16340,2262,17635,1717,33975,3979,"Marion County, Illinois(6,10)",91.5,49,"Marion County, Illinois",67.6,36,stable,38339,17,121,67.6,91.5
IL,"Marshall County, Illinois",1201,439,762,17123,53423,53658,NA,NA,NA,53802,5466,436,5677,329,11143,765,"Marshall County, Illinois(6,10)",58.5,12,"Marshall County, Illinois",44,9,stable,11982,17,123,44,58.5
IL,"Mason County, Illinois",2095,919,1176,17125,41567,41624,NA,NA,NA,NA,6283,631,6482,537,12765,1168,"Mason County, Illinois(6,10)",92.3,20,"Mason County, Illinois",63.9,14,stable,13701,17,125,63.9,92.3
IL,"Massac County, Illinois",2705,1251,1454,17127,40977,42512,23194,NA,35938,83452,6263,903,6897,731,13160,1634,"Massac County, Illinois(6,10)",100.9,22,"Massac County, Illinois",67.9,15,stable,14766,17,127,67.9,100.9
IL,"Menard County, Illinois",1404,603,801,17129,60486,60425,NA,NA,NA,NA,5691,395,6065,299,11756,694,"Menard County, Illinois(6,10)",75.9,13,"Menard County, Illinois",62.1,10,stable,12444,17,129,62.1,75.9
IL,"Mercer County, Illinois",1498,616,882,17131,54757,54468,NA,NA,66500,45625,7464,421,7559,407,15023,828,"Mercer County, Illinois(6,10)",76.7,19,"Mercer County, Illinois",48.2,12,stable,15858,17,131,48.2,76.7
IL,"Monroe County, Illinois",1667,529,1138,17133,70859,71255,NA,NA,NA,64417,15483,875,16248,643,31731,1518,"Monroe County, Illinois(6,10)",60.9,24,"Monroe County, Illinois",43.6,17,falling,33879,17,133,43.6,60.9
IL,"Montgomery County, Illinois",3503,1170,2333,17135,46966,46862,NA,NA,NA,66500,9479,581,13000,822,22479,1403,"Montgomery County, Illinois(6,10)",86.5,34,"Montgomery County, Illinois",68.5,28,stable,28898,17,135,68.5,86.5
IL,"Morgan County, Illinois",4580,2222,2358,17137,45978,47783,30265,NA,NA,35714,14710,1702,15971,980,30681,2682,"Morgan County, Illinois(6,10)",77.6,36,"Morgan County, Illinois",50.2,23,stable,34828,17,137,50.2,77.6
IL,"Moultrie County, Illinois",1929,1000,929,17139,49681,49910,NA,NA,NA,35357,6220,961,6573,851,12793,1812,"Moultrie County, Illinois(6,10)",56.9,11,"Moultrie County, Illinois",46.1,9,stable,14931,17,139,46.1,56.9
IL,"Ogle County, Illinois",5477,2460,3017,17141,54849,55420,42070,66000,NA,38979,23669,2237,23986,2004,47655,4241,"Ogle County, Illinois(6,10)",66.7,45,"Ogle County, Illinois",45.8,31,stable,51659,17,141,45.8,66.7
IL,"Peoria County, Illinois",31194,13602,17592,17143,51147,56363,25998,51250,83385,43125,80195,9174,88941,6532,169136,15706,"Peoria County, Illinois(6,10)",84,180,"Peoria County, Illinois",60.1,129,stable,186221,17,143,60.1,84
IL,"Perry County, Illinois",3380,1383,1997,17145,42478,43366,19917,NA,NA,NA,8538,1052,9344,779,17882,1831,"Perry County, Illinois(6,10)",74.4,21,"Perry County, Illinois",52.8,15,stable,21543,17,145,52.8,74.4
IL,"Piatt County, Illinois",1019,398,621,17147,66261,66763,NA,NA,NA,42292,7673,465,7898,409,15571,874,"Piatt County, Illinois(6,10)",79.8,18,"Piatt County, Illinois",53.1,12,stable,16387,17,147,53.1,79.8
IL,"Pike County, Illinois",2133,1011,1122,17149,40588,40865,NA,8750,250001,39844,6805,886,7199,721,14004,1607,"Pike County, Illinois(6,10)",68.4,17,"Pike County, Illinois",46,11,stable,15989,17,149,46,68.4
IL,"Pope County, Illinois",615,247,368,17151,39223,38851,NA,NA,NA,NA,1911,159,1934,122,3845,281,"Pope County, Illinois(6,10)",105.5,7,"Pope County, Illinois",69.4,4,stable,4226,17,151,69.4,105.5
IL,"Pulaski County, Illinois",1178,529,649,17153,31980,35236,25106,NA,NA,23500,2536,325,2743,259,5279,584,"Pulaski County, Illinois(6,10)",113.1,10,"Pulaski County, Illinois",74.3,7,stable,5678,17,153,74.3,113.1
IL,"Putnam County, Illinois",691,304,387,17155,56358,55776,NA,NA,NA,63125,2658,278,2665,215,5323,493,"Putnam County, Illinois(6,10)",73.5,7,"Putnam County, Illinois",55,5,stable,5644,17,155,55,73.5
IL,"Randolph County, Illinois",3816,1716,2100,17157,48158,50465,26875,NA,NA,68500,13720,1275,13830,1116,27550,2391,"Randolph County, Illinois(6,10)",78.6,33,"Randolph County, Illinois",52.6,22,stable,32852,17,157,52.6,78.6
IL,"Richland County, Illinois",2382,1001,1381,17159,44127,44340,NA,NA,NA,31250,7236,745,7280,656,14516,1401,"Richland County, Illinois(6,10)",81.6,19,"Richland County, Illinois",56.7,13,stable,16029,17,159,56.7,81.6
IL,"Rock Island County, Illinois",21223,9137,12086,17161,48817,50760,31869,18906,63359,40236,63474,7177,68428,5696,131902,12873,"Rock Island County, Illinois(6,10)",66.8,127,"Rock Island County, Illinois",52.4,101,falling,146133,17,161,52.4,66.8
IL,"St. Clair County, Illinois",47946,20261,27685,17163,49895,61682,27289,NA,72440,41273,109781,15069,125311,11067,235092,26136,"St. Clair County, Illinois(6,10)",75.8,219,"St. Clair County, Illinois",56.8,165,falling,264052,17,163,56.8,75.8
IL,"Saline County, Illinois",5534,2362,3172,17165,38258,39217,NA,NA,48182,24375,10329,1377,11365,1164,21694,2541,"Saline County, Illinois(6,10)",91.8,33,"Saline County, Illinois",69.5,25,stable,24548,17,165,69.5,91.8
IL,"Sangamon County, Illinois",30297,13769,16528,17167,56167,61044,26468,53281,67159,41054,85893,8590,96636,5726,182529,14316,"Sangamon County, Illinois(6,10)",77.6,183,"Sangamon County, Illinois",54.1,126,falling,198712,17,167,54.1,77.6
IL,"Schuyler County, Illinois",1382,885,497,17169,47723,47482,NA,NA,NA,24375,2901,954,3084,293,5985,1247,"Schuyler County, Illinois(6,10)",82.9,9,"Schuyler County, Illinois",61.5,7,stable,7032,17,169,61.5,82.9
IL,"Scott County, Illinois",712,332,380,17171,47222,47118,NA,NA,NA,NA,2232,281,2485,152,4717,433,"Scott County, Illinois(6,10)",83.2,6,"Scott County, Illinois",52.1,4,stable,5092,17,171,52.1,83.2
IL,"Shelby County, Illinois",2449,1159,1290,17173,47850,48071,NA,NA,39750,NA,9821,1147,10223,732,20044,1879,"Shelby County, Illinois(6,10)",77.1,25,"Shelby County, Illinois",46.9,16,stable,21775,17,173,46.9,77.1
IL,"Stark County, Illinois",684,271,413,17175,50085,50321,NA,NA,NA,60625,2569,280,2704,205,5273,485,"Stark County, Illinois(6,10)",77.3,7,"Stark County, Illinois",46.5,4,stable,5788,17,175,46.5,77.3
IL,"Stephenson County, Illinois",6849,2985,3864,17177,45331,47191,24795,NA,NA,41667,20113,2171,22010,1584,42123,3755,"Stephenson County, Illinois(6,10)",63.8,43,"Stephenson County, Illinois",52.6,36,stable,45749,17,177,52.6,63.8
IL,"Tazewell County, Illinois",11559,4787,6772,17179,58194,58688,NA,NA,98304,62118,60428,4933,63659,4342,124087,9275,"Tazewell County, Illinois(6,10)",87.2,151,"Tazewell County, Illinois",60.1,104,falling,134800,17,179,60.1,87.2
IL,"Union County, Illinois",2971,1495,1476,17181,42606,44158,NA,NA,NA,23500,7728,927,7935,808,15663,1735,"Union County, Illinois(6,10)",102.7,26,"Union County, Illinois",74.4,18,stable,17408,17,181,74.4,102.7
IL,"Vermilion County, Illinois",14571,6430,8141,17183,42977,46159,23053,21648,51472,35583,33321,4625,37214,2928,70535,7553,"Vermilion County, Illinois(6,10)",86.4,92,"Vermilion County, Illinois",64.8,70,stable,79282,17,183,64.8,86.4
IL,"Wabash County, Illinois",1447,617,830,17185,47491,46933,NA,NA,75500,2499,5240,427,5446,456,10686,883,"Wabash County, Illinois(6,10)",91.6,15,"Wabash County, Illinois",59.7,10,stable,11542,17,185,59.7,91.6
IL,"Warren County, Illinois",2464,992,1472,17187,43699,44519,39821,NA,36875,35781,7792,751,8299,666,16091,1417,"Warren County, Illinois(6,10)",74,17,"Warren County, Illinois",57.1,13,stable,17527,17,187,57.1,74
IL,"Washington County, Illinois",1834,861,973,17189,53202,53370,2499,NA,87813,35500,6555,581,6684,428,13239,1009,"Washington County, Illinois(6,10)",74.1,15,"Washington County, Illinois",43.4,9,stable,14270,17,189,43.4,74.1
IL,"Wayne County, Illinois",2385,1052,1333,17191,44993,45230,2499,NA,NA,NA,7396,786,7712,612,15108,1398,"Wayne County, Illinois(6,10)",89.2,22,"Wayne County, Illinois",66.4,17,stable,16423,17,191,66.4,89.2
IL,"White County, Illinois",1916,825,1091,17193,44648,44295,NA,NA,NA,35603,6151,687,6747,545,12898,1232,"White County, Illinois(6,10)",81.2,18,"White County, Illinois",69.5,16,stable,14327,17,193,69.5,81.2
IL,"Whiteside County, Illinois",6740,2999,3741,17195,47401,47739,34554,NA,123375,43133,25020,2804,26751,2076,51771,4880,"Whiteside County, Illinois(6,10)",71.8,57,"Whiteside County, Illinois",56.7,45,stable,57079,17,195,56.7,71.8
IL,"Will County, Illinois",53482,22781,30701,17197,76101,79701,55017,41618,107870,59611,303905,30668,319482,23374,623387,54042,"Will County, Illinois(6,10)",72,414,"Will County, Illinois",50.3,281,falling,687263,17,197,50.3,72
IL,"Williamson County, Illinois",9783,4284,5499,17199,44453,44983,31181,NA,72232,48021,28472,3366,30947,2498,59419,5864,"Williamson County, Illinois(6,10)",97.5,85,"Williamson County, Illinois",69.5,60,stable,67466,17,199,69.5,97.5
IL,"Winnebago County, Illinois",47851,21483,26368,17201,48225,51923,25371,34617,63722,37495,123333,16996,134331,12616,257664,29612,"Winnebago County, Illinois(6,10)",74,252,"Winnebago County, Illinois",57.7,198,stable,287078,17,201,57.7,74
IL,"Woodford County, Illinois",3105,1461,1644,17203,65852,65909,NA,NA,NA,65179,17966,1257,18355,970,36321,2227,"Woodford County, Illinois(6,10)",61,29,"Woodford County, Illinois",45.8,22,stable,39227,17,203,45.8,61
IN,"Adams County, Indiana",5529,2596,2933,18001,48188,49107,NA,NA,NA,51473,12964,4012,13100,4142,26064,8154,"Adams County, Indiana(6,10)",50.2,19,"Adams County, Indiana",32.9,13,stable,34980,18,1,32.9,50.2
IN,"Allen County, Indiana",56542,25163,31379,18003,49092,52934,27017,40725,42569,37399,150074,25374,160131,24245,310205,49619,"Allen County, Indiana(6,10)",61.9,227,"Allen County, Indiana",44.8,163,falling,368450,18,3,44.8,61.9
IN,"Bartholomew County, Indiana",10027,4645,5382,18005,55050,53707,51758,NA,88061,40043,34684,4348,34960,4574,69644,8922,"Bartholomew County, Indiana(6,10)",77.8,69,"Bartholomew County, Indiana",59.2,53,stable,81162,18,5,59.2,77.8
IN,"Benton County, Indiana",1181,512,669,18007,47046,47074,46250,NA,NA,33958,3646,702,3807,512,7453,1214,"Benton County, Indiana(6,10)",82.7,9,"Benton County, Indiana",79.3,9,rising,8681,18,7,79.3,82.7
IN,"Blackford County, Indiana",1700,664,1036,18009,38190,38326,NA,NA,NA,NA,5134,903,5344,923,10478,1826,"Blackford County, Indiana(6,10)",74.9,13,"Blackford County, Indiana",51.8,10,stable,12298,18,9,51.8,74.9
IN,"Boone County, Indiana",3498,1551,1947,18011,67552,67769,NA,NA,81250,53836,27235,2530,27975,2173,55210,4703,"Boone County, Indiana(6,10)",67,39,"Boone County, Indiana",56.6,31,stable,63344,18,11,56.6,67
IN,"Brown County, Indiana",1865,959,906,18013,54615,54961,NA,NA,NA,76731,6408,1077,6463,932,12871,2009,"Brown County, Indiana(6,10)",61.8,14,"Brown County, Indiana",60.2,13,stable,14977,18,13,60.2,61.8
IN,"Carroll County, Indiana",2149,895,1254,18015,52005,51852,NA,NA,NA,33643,8330,1557,8678,1334,17008,2891,"Carroll County, Indiana(6,10)",66.1,17,"Carroll County, Indiana",39.8,10,stable,19856,18,15,39.8,66.1
IN,"Cass County, Indiana",5884,2717,3167,18017,42290,43277,NA,NA,54107,32148,15674,3128,16226,2792,31900,5920,"Cass County, Indiana(6,10)",89.5,42,"Cass County, Indiana",65.8,31,stable,37979,18,17,65.8,89.5
IN,"Clark County, Indiana",12009,5616,6393,18019,51699,53170,39841,NA,48783,50982,46813,7703,50697,6414,97510,14117,"Clark County, Indiana(6,10)",88.1,107,"Clark County, Indiana",67.3,81,falling,115371,18,19,67.3,88.1
IN,"Clay County, Indiana",3807,1695,2112,18021,47602,47960,NA,7109,NA,NA,11270,1629,11934,1533,23204,3162,"Clay County, Indiana(6,10)",73.8,25,"Clay County, Indiana",58.4,20,stable,26503,18,21,58.4,73.8
IN,"Clinton County, Indiana",4504,2018,2486,18023,48478,48946,42692,68906,49904,35441,13628,2176,14134,2246,27762,4422,"Clinton County, Indiana(6,10)",76.2,29,"Clinton County, Indiana",62.2,24,stable,32609,18,23,62.2,76.2
IN,"Crawford County, Indiana",2166,975,1191,18025,38695,38618,NA,47614,NA,36635,4818,520,4698,496,9516,1016,"Crawford County, Indiana(6,10)",94.6,13,"Crawford County, Indiana",70.5,10,stable,10483,18,25,70.5,94.6
IN,"Daviess County, Indiana",4192,1934,2258,18027,47342,47598,NA,NA,NA,40515,12618,3375,12601,3357,25219,6732,"Daviess County, Indiana(6,10)",62.8,23,"Daviess County, Indiana",56,20,stable,32906,18,27,56,62.8
IN,"Dearborn County, Indiana",4553,1982,2571,18029,58680,58943,31324,NA,NA,61850,22206,2249,22495,2168,44701,4417,"Dearborn County, Indiana(6,10)",82.3,48,"Dearborn County, Indiana",64.1,37,stable,49455,18,29,64.1,82.3
IN,"Decatur County, Indiana",3647,1518,2129,18031,49799,49314,37059,NA,57352,NA,11143,1689,11404,1686,22547,3375,"Decatur County, Indiana(6,10)",69.6,21,"Decatur County, Indiana",56.9,17,stable,26521,18,31,56.9,69.6
IN,"DeKalb County, Indiana",6107,2741,3366,18033,48341,48097,NA,NA,61354,34777,18100,2885,18259,2832,36359,5717,"DeKalb County, Indiana(6,10)",68.5,33,"DeKalb County, Indiana",53.2,25,stable,42589,18,33,53.2,68.5
IN,"Delaware County, Indiana",24209,10795,13414,18035,38830,40362,25152,15870,15987,28313,47799,7995,53817,6250,101616,14245,"Delaware County, Indiana(6,10)",79.9,108,"Delaware County, Indiana",58.6,80,stable,116852,18,35,58.6,79.9
IN,"Dubois County, Indiana",4071,1772,2299,18037,53513,54508,NA,NA,NA,27166,19082,1645,19285,1483,38367,3128,"Dubois County, Indiana(6,10)",55,28,"Dubois County, Indiana",40.3,20,stable,42461,18,37,40.3,55
IN,"Elkhart County, Indiana",31601,12817,18784,18039,47913,49448,22094,49922,66944,40256,78600,19159,81781,18674,160381,37833,"Elkhart County, Indiana(6,10)",70.2,144,"Elkhart County, Indiana",48.6,99,stable,203474,18,39,48.6,70.2
IN,"Fayette County, Indiana",4806,2129,2677,18041,39379,40301,29402,NA,40481,22138,9694,1943,9985,1830,19679,3773,"Fayette County, Indiana(6,10)",87.4,29,"Fayette County, Indiana",71.4,24,stable,23434,18,41,71.4,87.4
IN,"Floyd County, Indiana",9530,4041,5489,18043,54914,57181,22254,28382,63125,48409,32243,4169,34587,3904,66830,8073,"Floyd County, Indiana(6,10)",79.3,67,"Floyd County, Indiana",54.2,46,falling,76778,18,43,54.2,79.3
IN,"Fountain County, Indiana",1992,870,1122,18045,46760,47100,NA,NA,NA,43462,7363,1018,7597,737,14960,1755,"Fountain County, Indiana(6,10)",82.3,20,"Fountain County, Indiana",62.2,15,stable,16591,18,45,62.2,82.3
IN,"Franklin County, Indiana",2413,1094,1319,18047,51748,51579,NA,NA,NA,58977,10385,1059,10442,968,20827,2027,"Franklin County, Indiana(6,10)",64.7,18,"Franklin County, Indiana",57.1,16,stable,22872,18,47,57.1,64.7
IN,"Fulton County, Indiana",3011,1441,1570,18049,45332,45206,70972,NA,NA,44792,8761,1357,8876,1304,17637,2661,"Fulton County, Indiana(6,10)",83.8,23,"Fulton County, Indiana",70,19,stable,20315,18,49,70,83.8
IN,"Gibson County, Indiana",3675,1611,2064,18051,48303,48964,33889,NA,NA,NA,14615,1936,14958,1606,29573,3542,"Gibson County, Indiana(6,10)",70,29,"Gibson County, Indiana",48.6,20,stable,33775,18,51,48.6,70
IN,"Grant County, Indiana",11829,5068,6761,18053,40294,41915,24351,23203,35677,38021,27995,4428,31014,4506,59009,8934,"Grant County, Indiana(6,10)",85.5,78,"Grant County, Indiana",64,59,stable,67979,18,53,64,85.5
IN,"Greene County, Indiana",4398,1869,2529,18055,45397,45665,NA,NA,NA,40385,13772,2387,14446,1927,28218,4314,"Greene County, Indiana(6,10)",81.1,35,"Greene County, Indiana",69.5,30,stable,32441,18,55,69.5,81.1
IN,"Hamilton County, Indiana",13889,5730,8159,18057,86222,86143,68029,67063,104491,66445,133967,10141,141488,9471,275455,19612,"Hamilton County, Indiana(6,10)",46.7,102,"Hamilton County, Indiana",33.6,73,falling,309697,18,57,33.6,46.7
IN,"Hancock County, Indiana",4583,1738,2845,18059,66606,66779,NA,NA,88700,72202,31559,3012,33142,2993,64701,6005,"Hancock County, Indiana(6,10)",83.1,65,"Hancock County, Indiana",59.2,45,stable,72520,18,59,59.2,83.1
IN,"Harrison County, Indiana",5392,2399,2993,18061,52128,52081,114278,NA,NA,68833,17348,2105,17730,1840,35078,3945,"Harrison County, Indiana(6,10)",90.7,43,"Harrison County, Indiana",62.9,29,stable,39578,18,61,62.9,90.7
IN,"Hendricks County, Indiana",7514,2643,4871,18063,70163,70927,64035,30408,61121,54239,67526,6690,70754,5627,138280,12317,"Hendricks County, Indiana(6,10)",69.9,98,"Hendricks County, Indiana",50.5,69,falling,158192,18,63,50.5,69.9
IN,"Henry County, Indiana",7465,3105,4360,18065,41855,42009,NA,58036,NA,35208,18933,3496,20315,3185,39248,6681,"Henry County, Indiana(6,10)",76.6,49,"Henry County, Indiana",65.1,42,stable,48985,18,65,65.1,76.6
IN,"Howard County, Indiana",14445,6520,7925,18067,44226,46114,21813,NA,46964,41332,34676,4721,37634,4798,72310,9519,"Howard County, Indiana(6,10)",75,81,"Howard County, Indiana",52.4,57,falling,82556,18,67,52.4,75
IN,"Huntington County, Indiana",4241,1829,2412,18069,46945,46941,NA,78125,60650,32083,15653,2203,16607,1913,32260,4116,"Huntington County, Indiana(6,10)",65,29,"Huntington County, Indiana",50.5,23,stable,36630,18,69,50.5,65
IN,"Jackson County, Indiana",6297,2608,3689,18071,47000,47824,NA,20000,90033,28243,18573,2785,18665,2816,37238,5601,"Jackson County, Indiana(6,10)",81.4,42,"Jackson County, Indiana",70.7,37,rising,44069,18,71,70.7,81.4
IN,"Jasper County, Indiana",2710,1252,1458,18073,55374,55925,42014,NA,NA,53478,14816,1581,14772,1932,29588,3513,"Jasper County, Indiana(6,10)",85.6,33,"Jasper County, Indiana",69.4,27,stable,33470,18,73,69.4,85.6
IN,"Jay County, Indiana",3400,1570,1830,18075,41021,40993,NA,30750,120521,NA,8849,1480,9460,1250,18309,2730,"Jay County, Indiana(6,10)",68.9,18,"Jay County, Indiana",57.7,15,stable,21121,18,75,57.7,68.9
IN,"Jefferson County, Indiana",4343,1949,2394,18077,45718,45900,40441,NA,50938,45060,13271,2024,13793,1916,27064,3940,"Jefferson County, Indiana(6,10)",81.7,32,"Jefferson County, Indiana",58.5,23,stable,32416,18,77,58.5,81.7
IN,"Jennings County, Indiana",4390,2189,2201,18079,44736,45379,19750,NA,26250,NA,12221,1730,12293,1615,24514,3345,"Jennings County, Indiana(6,10)",97.9,30,"Jennings County, Indiana",62.5,20,stable,27897,18,79,62.5,97.9
IN,"Johnson County, Indiana",14205,6368,7837,18081,62147,62622,69279,47039,66106,26880,62927,7284,66581,6702,129508,13986,"Johnson County, Indiana(6,10)",67.9,101,"Johnson County, Indiana",50.1,73,falling,149633,18,81,50.1,67.9
IN,"Knox County, Indiana",5630,2479,3151,18083,42725,43270,36477,NA,NA,33646,16560,2242,15792,2655,32352,4897,"Knox County, Indiana(6,10)",76,37,"Knox County, Indiana",53.6,26,stable,37927,18,83,53.6,76
IN,"Kosciusko County, Indiana",8645,3964,4681,18085,52821,53105,48650,NA,82177,46228,32774,5682,33738,5039,66512,10721,"Kosciusko County, Indiana(6,10)",71.6,64,"Kosciusko County, Indiana",54,47,stable,78620,18,85,54,71.6
IN,"LaGrange County, Indiana",4909,2157,2752,18087,49964,49958,NA,40469,NA,40170,11118,8061,10668,8069,21786,16130,"LaGrange County, Indiana(6,10)",56.4,21,"LaGrange County, Indiana",41.5,15,stable,38809,18,87,41.5,56.4
IN,"Lake County, Indiana",87203,37304,49899,18089,50135,58970,31299,53828,74844,47355,201307,34810,220117,31833,421424,66643,"Lake County, Indiana(6,10)",74,412,"Lake County, Indiana",53.8,298,falling,487865,18,89,53.8,74
IN,"LaPorte County, Indiana",17792,7191,10601,18091,46872,50346,25071,35505,32152,39933,43254,5861,47298,5999,90552,11860,"LaPorte County, Indiana(6,10)",77.2,103,"LaPorte County, Indiana",55.9,74,falling,110884,18,91,55.9,77.2
IN,"Lawrence County, Indiana",5850,2758,3092,18093,45875,46347,NA,NA,NA,27054,18953,3406,19695,3087,38648,6493,"Lawrence County, Indiana(6,10)",89.5,55,"Lawrence County, Indiana",66,41,stable,45495,18,93,66,89.5
IN,"Madison County, Indiana",21089,9753,11336,18095,44195,45970,30488,NA,22361,27417,51832,8896,56889,7522,108721,16418,"Madison County, Indiana(6,10)",81.8,133,"Madison County, Indiana",67.8,111,stable,129723,18,95,67.8,81.8
IN,"Marion County, Indiana",191309,86399,104910,18097,42168,49931,30508,35283,47899,29004,362748,78114,411127,64482,773875,142596,"Marion County, Indiana(6,10)",79.7,682,"Marion County, Indiana",64.3,545,falling,939020,18,97,64.3,79.7
IN,"Marshall County, Indiana",5594,2265,3329,18099,48485,48479,NA,89271,NA,39316,19603,3532,19708,3640,39311,7172,"Marshall County, Indiana(6,10)",67.1,39,"Marshall County, Indiana",45.1,26,falling,46857,18,99,45.1,67.1
IN,"Martin County, Indiana",1320,532,788,18101,44589,45671,NA,NA,NA,NA,4408,705,4409,647,8817,1352,"Martin County, Indiana(6,10)",71.5,10,"Martin County, Indiana",58.6,8,stable,10226,18,101,58.6,71.5
IN,"Miami County, Indiana",5174,2271,2903,18103,45184,45321,64964,38750,NA,38333,15202,2349,14794,1817,29996,4166,"Miami County, Indiana(6,10)",77.1,34,"Miami County, Indiana",68,29,stable,35862,18,103,68,77.1
IN,"Monroe County, Indiana",31707,15337,16370,18105,42404,45342,21604,43701,15759,35156,62102,8313,63785,7277,125887,15590,"Monroe County, Indiana(6,10)",66.9,81,"Monroe County, Indiana",49.7,61,stable,144705,18,105,49.7,66.9
IN,"Montgomery County, Indiana",5153,2408,2745,18107,48213,48202,50645,NA,105859,32120,16552,2590,16354,2147,32906,4737,"Montgomery County, Indiana(6,10)",70,33,"Montgomery County, Indiana",54.5,26,stable,38227,18,107,54.5,70
IN,"Morgan County, Indiana",8237,3406,4831,18109,55432,55947,NA,NA,NA,40000,29956,3980,31211,3523,61167,7503,"Morgan County, Indiana(6,10)",83.9,65,"Morgan County, Indiana",66.4,52,stable,69648,18,109,66.4,83.9
IN,"Newton County, Indiana",1892,703,1189,18111,46895,46868,NA,NA,NA,54357,5948,1060,5930,916,11878,1976,"Newton County, Indiana(6,10)",75.3,15,"Newton County, Indiana",65.7,13,stable,14008,18,111,65.7,75.3
IN,"Noble County, Indiana",5665,2582,3083,18113,49331,49246,NA,95288,NA,42721,20425,2984,20259,3059,40684,6043,"Noble County, Indiana(6,10)",69,35,"Noble County, Indiana",54.7,28,stable,47733,18,113,54.7,69
IN,"Ohio County, Indiana",470,219,251,18115,48780,48601,NA,NA,NA,NA,2633,363,2688,297,5321,660,"Ohio County, Indiana(6,10)",123.2,10,"Ohio County, Indiana",80.6,7,stable,5938,18,115,80.6,123.2
IN,"Orange County, Indiana",3403,1562,1841,18117,39812,39888,NA,NA,NA,NA,8431,1230,8677,1134,17108,2364,"Orange County, Indiana(6,10)",85.4,22,"Orange County, Indiana",69.7,18,stable,19605,18,117,69.7,85.4
IN,"Owen County, Indiana",3172,1535,1637,18119,43948,44024,NA,NA,NA,NA,8672,1969,8981,1411,17653,3380,"Owen County, Indiana(6,10)",85,24,"Owen County, Indiana",62.9,17,stable,20872,18,119,62.9,85
IN,"Parke County, Indiana",2486,1103,1383,18121,40781,41169,NA,NA,NA,21607,6668,1341,6589,981,13257,2322,"Parke County, Indiana(6,10)",75.1,17,"Parke County, Indiana",64,14,stable,16901,18,121,64,75.1
IN,"Perry County, Indiana",2276,1020,1256,18123,47470,48240,21225,NA,NA,NA,7972,836,8028,831,16000,1667,"Perry County, Indiana(6,10)",101.2,24,"Perry County, Indiana",76,18,rising,19347,18,123,76,101.2
IN,"Pike County, Indiana",1243,579,664,18125,44399,44620,NA,NA,NA,NA,5557,670,5607,629,11164,1299,"Pike County, Indiana(6,10)",66.6,12,"Pike County, Indiana",57.9,10,stable,12594,18,125,57.9,66.6
IN,"Porter County, Indiana",18850,8093,10757,18127,63926,64594,42720,NA,80938,62785,73133,8037,75759,8265,148892,16302,"Porter County, Indiana(6,10)",73.6,133,"Porter County, Indiana",52.9,95,falling,167688,18,127,52.9,73.6
IN,"Posey County, Indiana",2801,1480,1321,18129,58101,59167,54306,NA,NA,NA,11771,823,11940,782,23711,1605,"Posey County, Indiana(6,10)",60.3,19,"Posey County, Indiana",41.3,13,falling,25512,18,129,41.3,60.3
IN,"Pulaski County, Indiana",1808,707,1101,18131,43836,44138,15833,NA,NA,32232,5661,855,5588,777,11249,1632,"Pulaski County, Indiana(6,10)",71.1,13,"Pulaski County, Indiana",64.5,12,stable,12889,18,131,64.5,71.1
IN,"Putnam County, Indiana",3245,1391,1854,18133,51355,51613,45089,NA,73194,NA,14904,2042,15700,1728,30604,3770,"Putnam County, Indiana(6,10)",95.1,41,"Putnam County, Indiana",76.4,33,stable,37585,18,133,76.4,95.1
IN,"Randolph County, Indiana",4522,1782,2740,18135,40810,41008,45000,NA,NA,31857,10277,2030,11109,1822,21386,3852,"Randolph County, Indiana(6,10)",83.1,29,"Randolph County, Indiana",59.1,21,stable,25172,18,135,59.1,83.1
IN,"Ripley County, Indiana",2403,1042,1361,18137,51170,51376,NA,NA,NA,51500,12406,1488,13193,1063,25599,2551,"Ripley County, Indiana(6,10)",75.6,27,"Ripley County, Indiana",57.8,20,falling,28701,18,137,57.8,75.6
IN,"Rush County, Indiana",2946,1189,1757,18139,45121,45833,30153,NA,NA,NA,7088,1260,7480,976,14568,2236,"Rush County, Indiana(6,10)",80.8,18,"Rush County, Indiana",67.5,15,stable,16672,18,139,67.5,80.8
IN,"St. Joseph County, Indiana",45532,19992,25540,18141,45471,49959,23364,26769,53302,37091,110161,17834,121115,15619,231276,33453,"St. Joseph County, Indiana(6,10)",71.5,212,"St. Joseph County, Indiana",52.2,157,falling,268441,18,141,52.2,71.5
IN,"Scott County, Indiana",4148,1896,2252,18143,44442,44526,NA,NA,NA,NA,9893,1578,10912,1052,20805,2630,"Scott County, Indiana(6,10)",91.8,26,"Scott County, Indiana",81.2,23,stable,23744,18,143,81.2,91.8
IN,"Shelby County, Indiana",5302,2258,3044,18145,53584,54330,23872,NA,100139,42326,18589,2948,19630,2561,38219,5509,"Shelby County, Indiana(6,10)",81.8,43,"Shelby County, Indiana",56.2,30,stable,44478,18,145,56.2,81.8
IN,"Spencer County, Indiana",2213,906,1307,18147,55247,55317,55625,NA,NA,NA,9548,894,9375,821,18923,1715,"Spencer County, Indiana(6,10)",77.9,21,"Spencer County, Indiana",51.3,14,stable,20715,18,147,51.3,77.9
IN,"Starke County, Indiana",3682,1634,2048,18149,42208,43110,NA,NA,55833,35827,10130,1260,10415,1307,20545,2567,"Starke County, Indiana(6,10)",93.5,29,"Starke County, Indiana",75.3,23,stable,22958,18,149,75.3,93.5
IN,"Steuben County, Indiana",3542,1577,1965,18151,48472,48554,NA,70625,55278,46130,15095,2153,14737,2002,29832,4155,"Steuben County, Indiana(6,10)",71,31,"Steuben County, Indiana",46.7,20,stable,34372,18,151,46.7,71
IN,"Sullivan County, Indiana",3534,1469,2065,18153,45023,45018,NA,NA,NA,NA,7878,1578,8160,1317,16038,2895,"Sullivan County, Indiana(6,10)",81.8,22,"Sullivan County, Indiana",64,17,stable,20928,18,153,64,81.8
IN,"Switzerland County, Indiana",2022,1025,997,18155,44061,43626,64250,NA,NA,NA,4519,866,4272,731,8791,1597,"Switzerland County, Indiana(6,10)",84.7,11,"Switzerland County, Indiana",80,10,stable,10524,18,155,80,84.7
IN,"Tippecanoe County, Indiana",36902,18433,18469,18157,45932,49335,19199,71071,21343,40556,80039,11380,78153,9682,158192,21062,"Tippecanoe County, Indiana(6,10)",64,91,"Tippecanoe County, Indiana",47.2,66,falling,185826,18,157,47.2,64
IN,"Tipton County, Indiana",1529,732,797,18159,51613,51935,NA,NA,NA,NA,6741,937,6682,1027,13423,1964,"Tipton County, Indiana(6,10)",73.3,16,"Tipton County, Indiana",43.6,10,stable,15267,18,159,43.6,73.3
IN,"Union County, Indiana",754,372,382,18161,44277,44818,NA,NA,NA,NA,3159,488,3209,381,6368,869,"Union County, Indiana(6,10)",65.2,7,"Union County, Indiana",48.9,5,stable,7182,18,161,48.9,65.2
IN,"Vanderburgh County, Indiana",28870,12815,16055,18163,43046,46584,21430,23854,44797,39545,75092,11396,82866,9443,157958,20839,"Vanderburgh County, Indiana(6,10)",79.6,169,"Vanderburgh County, Indiana",57.2,122,falling,181877,18,163,57.2,79.6
IN,"Vermillion County, Indiana",1996,896,1100,18165,43600,43728,NA,NA,NA,29280,6822,900,7071,856,13893,1756,"Vermillion County, Indiana(6,10)",92.6,20,"Vermillion County, Indiana",79.9,18,stable,15692,18,165,79.9,92.6
IN,"Vigo County, Indiana",20245,9199,11046,18167,40313,41000,24240,45956,51364,36576,44041,7289,45578,7081,89619,14370,"Vigo County, Indiana(6,10)",80.4,96,"Vigo County, Indiana",65,77,stable,107896,18,167,65,80.4
IN,"Wabash County, Indiana",4373,1771,2602,18169,45649,45263,NA,59231,NA,50870,13812,1655,14518,1409,28330,3064,"Wabash County, Indiana(6,10)",64.3,28,"Wabash County, Indiana",46.5,20,stable,32138,18,169,46.5,64.3
IN,"Warren County, Indiana",740,297,443,18171,56042,56222,NA,NA,NA,95938,3822,278,3874,301,7696,579,"Warren County, Indiana(6,10)",66,7,"Warren County, Indiana",53.6,6,stable,8269,18,171,53.6,66
IN,"Warrick County, Indiana",5926,2551,3375,18173,62185,62256,49500,23830,NA,43295,27350,2520,28236,2148,55586,4668,"Warrick County, Indiana(6,10)",66.7,47,"Warrick County, Indiana",46.7,32,stable,61897,18,173,46.7,66.7
IN,"Washington County, Indiana",4190,1900,2290,18175,41289,41920,NA,NA,NA,NA,11739,1976,12453,1484,24192,3460,"Washington County, Indiana(6,10)",96.2,33,"Washington County, Indiana",69.6,23,stable,27827,18,175,69.6,96.2
IN,"Wayne County, Indiana",13732,6012,7720,18177,38494,39232,28188,NA,NA,27270,26546,5708,28928,5548,55474,11256,"Wayne County, Indiana(6,10)",85.2,77,"Wayne County, Indiana",65,58,stable,67001,18,177,65,85.2
IN,"Wells County, Indiana",3306,1449,1857,18179,51101,51730,38167,NA,NA,30523,12159,1298,12294,1480,24453,2778,"Wells County, Indiana(6,10)",52.4,19,"Wells County, Indiana",42.9,15,falling,27964,18,179,42.9,52.4
IN,"White County, Indiana",2309,1029,1280,18181,52154,52199,NA,NA,NA,40194,10690,1293,10944,1212,21634,2505,"White County, Indiana(6,10)",76.2,26,"White County, Indiana",64.4,22,stable,24293,18,181,64.4,76.2
IN,"Whitley County, Indiana",2633,1208,1425,18183,54389,54561,NA,67917,35833,NA,14968,1515,15078,1388,30046,2903,"Whitley County, Indiana(6,10)",63.8,26,"Whitley County, Indiana",52.1,21,stable,33406,18,183,52.1,63.8
KS,"Allen County, Kansas",2257,957,1300,20001,38698,39505,38482,20833,NA,39500,5602,779,5754,741,11356,1520,"Allen County, Kansas(6)",_,_,"Allen County, Kansas",52.2,10,stable,12717,20,1,52.2,NA
KS,"Anderson County, Kansas",1362,668,694,20003,40696,40370,NA,81200,NA,NA,3391,487,3407,509,6798,996,"Anderson County, Kansas(6)",_,_,"Anderson County, Kansas",50.6,6,stable,7808,20,3,50.6,NA
KS,"Atchison County, Kansas",2970,1310,1660,20005,43581,44353,22375,NA,NA,NA,6755,1145,7594,963,14349,2108,"Atchison County, Kansas(6)",_,_,"Atchison County, Kansas",51.1,10,stable,16398,20,5,51.1,NA
KS,"Barber County, Kansas",511,245,266,20007,51811,51658,NA,NA,NA,65938,2170,220,2078,261,4248,481,"Barber County, Kansas(6)",_,_,"Barber County, Kansas",56,4,stable,4823,20,7,56,NA
KS,"Barton County, Kansas",4261,1840,2421,20009,44013,45325,22326,18958,NA,22247,11051,2075,12159,1703,23210,3778,"Barton County, Kansas(6)",_,_,"Barton County, Kansas",45.5,17,stable,27103,20,9,45.5,NA
KS,"Bourbon County, Kansas",2757,1175,1582,20011,38280,39231,NA,NA,62344,40250,6495,677,6594,773,13089,1450,"Bourbon County, Kansas(6)",_,_,"Bourbon County, Kansas",47.5,10,stable,14712,20,11,47.5,NA
KS,"Brown County, Kansas",1598,669,929,20013,43724,45619,32366,30268,48125,30119,4257,506,4456,590,8713,1096,"Brown County, Kansas(6)",_,_,"Brown County, Kansas",53.6,8,**,9776,20,13,53.6,NA
KS,"Butler County, Kansas",6620,2830,3790,20015,58897,58928,NA,19487,77460,58136,28486,2977,29710,2918,58196,5895,"Butler County, Kansas(6)",_,_,"Butler County, Kansas",53,38,stable,66741,20,15,53,NA
KS,"Chase County, Kansas",360,164,196,20017,38707,39655,NA,NA,NA,58333,1131,124,1222,125,2353,249,"Chase County, Kansas(6)",_,_,"Chase County, Kansas",*,*,*,2679,20,17,NA,NA
KS,"Chautauqua County, Kansas",579,261,318,20019,37993,39079,NA,NA,NA,73125,1521,247,1429,246,2950,493,"Chautauqua County, Kansas(6)",_,_,"Chautauqua County, Kansas",80.1,5,**,3402,20,19,80.1,NA
KS,"Cherokee County, Kansas",3511,1673,1838,20021,41388,41126,NA,51393,NA,71528,8766,1516,9103,1346,17869,2862,"Cherokee County, Kansas(6)",_,_,"Cherokee County, Kansas",63.2,17,stable,20533,20,21,63.2,NA
KS,"Cheyenne County, Kansas",214,93,121,20023,44500,43875,NA,NA,NA,25893,1218,121,1176,126,2394,247,"Cheyenne County, Kansas(6)",_,_,"Cheyenne County, Kansas",*,*,**,2679,20,23,NA,NA
KS,"Clark County, Kansas",311,128,183,20025,42589,42589,NA,NA,NA,38393,923,102,947,113,1870,215,"Clark County, Kansas(6)",_,_,"Clark County, Kansas",*,*,**,2096,20,25,NA,NA
KS,"Clay County, Kansas",942,368,574,20027,52066,52293,NA,75278,NA,NA,3729,200,3921,272,7650,472,"Clay County, Kansas(6)",_,_,"Clay County, Kansas",52.9,7,**,8347,20,27,52.9,NA
KS,"Cloud County, Kansas",1202,623,579,20029,39282,39421,NA,NA,NA,NA,3958,606,4098,452,8056,1058,"Cloud County, Kansas(6)",_,_,"Cloud County, Kansas",48.4,7,stable,9219,20,29,48.4,NA
KS,"Coffey County, Kansas",833,425,408,20031,57433,56964,NA,70682,NA,NA,3749,456,3769,372,7518,828,"Coffey County, Kansas(6)",_,_,"Coffey County, Kansas",54.4,7,stable,8384,20,31,54.4,NA
KS,"Comanche County, Kansas",140,40,100,20033,45288,46010,NA,NA,NA,NA,871,110,801,154,1672,264,"Comanche County, Kansas(6)",_,_,"Comanche County, Kansas",*,*,**,1843,20,33,NA,NA
KS,"Cowley County, Kansas",5971,2742,3229,20035,43860,43915,45347,41875,61200,38750,15033,2174,15862,1800,30895,3974,"Cowley County, Kansas(6)",_,_,"Cowley County, Kansas",43.1,20,falling,35788,20,35,43.1,NA
KS,"Crawford County, Kansas",8219,4161,4058,20037,36534,37157,31500,NA,2499,29961,16719,2730,16792,2435,33511,5165,"Crawford County, Kansas(6)",_,_,"Crawford County, Kansas",59,26,stable,39217,20,37,59,NA
KS,"Decatur County, Kansas",316,108,208,20039,40657,40833,NA,NA,NA,NA,1209,202,1258,150,2467,352,"Decatur County, Kansas(6)",_,_,"Decatur County, Kansas",*,*,**,2932,20,39,NA,NA
KS,"Dickinson County, Kansas",2005,735,1270,20041,49096,49245,NA,110543,NA,45903,8495,940,8913,684,17408,1624,"Dickinson County, Kansas(6)",_,_,"Dickinson County, Kansas",54.8,15,stable,19303,20,41,54.8,NA
KS,"Doniphan County, Kansas",892,444,448,20043,47209,49209,18182,36083,NA,33750,3369,577,3345,455,6714,1032,"Doniphan County, Kansas(6)",_,_,"Doniphan County, Kansas",58.1,6,stable,7797,20,43,58.1,NA
KS,"Douglas County, Kansas",20137,10447,9690,20045,50939,52173,38934,60144,29554,39315,51058,6065,51232,5902,102290,11967,"Douglas County, Kansas(6)",_,_,"Douglas County, Kansas",41.2,36,stable,118053,20,45,41.2,NA
KS,"Edwards County, Kansas",335,161,174,20047,47303,48139,NA,NA,NA,36154,1290,168,1206,232,2496,400,"Edwards County, Kansas(6)",_,_,"Edwards County, Kansas",*,*,**,2968,20,47,NA,NA
KS,"Elk County, Kansas",483,241,242,20049,36458,36111,NA,NA,NA,63611,1202,115,1159,159,2361,274,"Elk County, Kansas(6)",_,_,"Elk County, Kansas",56.1,3,stable,2605,20,49,56.1,NA
KS,"Ellis County, Kansas",4353,2259,2094,20051,45579,47280,NA,NA,2499,25263,12905,1447,13225,1140,26130,2587,"Ellis County, Kansas(6)",_,_,"Ellis County, Kansas",37.7,12,stable,29029,20,51,37.7,NA
KS,"Ellsworth County, Kansas",484,171,313,20053,47736,48615,NA,NA,NA,50208,2503,175,2531,190,5034,365,"Ellsworth County, Kansas(6)",_,_,"Ellsworth County, Kansas",42.8,4,**,6343,20,53,42.8,NA
KS,"Finney County, Kansas",6222,2572,3650,20055,49227,52302,29522,26458,48732,44520,15943,2762,15431,2753,31374,5515,"Finney County, Kansas(6)",_,_,"Finney County, Kansas",40.2,11,falling,37118,20,55,40.2,NA
KS,"Ford County, Kansas",6183,3303,2880,20057,50777,51687,21447,55682,27895,44796,14180,3495,13457,3112,27637,6607,"Ford County, Kansas(6)",_,_,"Ford County, Kansas",41.2,12,stable,34536,20,57,41.2,NA
KS,"Franklin County, Kansas",3264,1515,1749,20059,51081,52234,NA,NA,NA,30302,11434,1146,11906,1105,23340,2251,"Franklin County, Kansas(6)",_,_,"Franklin County, Kansas",53,16,stable,25609,20,59,53,NA
KS,"Geary County, Kansas",4463,1978,2485,20061,43992,43804,46568,44583,41641,32679,12763,1900,15626,1357,28389,3257,"Geary County, Kansas(6)",_,_,"Geary County, Kansas",71.4,16,stable,37030,20,61,71.4,NA
KS,"Gove County, Kansas",219,119,100,20063,46364,46288,NA,NA,NA,NA,1197,166,1179,139,2376,305,"Gove County, Kansas(6)",_,_,"Gove County, Kansas",*,*,**,2640,20,63,NA,NA
KS,"Graham County, Kansas",287,85,202,20065,43826,46964,31250,NA,NA,46250,1142,110,1230,83,2372,193,"Graham County, Kansas(6)",_,_,"Graham County, Kansas",*,*,**,2591,20,65,NA,NA
KS,"Grant County, Kansas",795,368,427,20067,55432,57924,NA,NA,NA,53988,3212,712,3069,744,6281,1456,"Grant County, Kansas(6)",_,_,"Grant County, Kansas",*,*,**,7733,20,67,NA,NA
KS,"Gray County, Kansas",597,252,345,20069,61000,60318,NA,NA,NA,42656,2642,321,2664,352,5306,673,"Gray County, Kansas(6)",_,_,"Gray County, Kansas",*,*,**,6133,20,69,NA,NA
KS,"Greeley County, Kansas",97,38,59,20071,47750,46776,NA,NA,NA,35000,558,45,560,33,1118,78,"Greeley County, Kansas(6)",_,_,"Greeley County, Kansas",*,*,**,1330,20,71,NA,NA
KS,"Greenwood County, Kansas",945,408,537,20073,38838,38914,NA,NA,NA,NA,2702,374,2828,399,5530,773,"Greenwood County, Kansas(6)",_,_,"Greenwood County, Kansas",52.3,6,stable,6244,20,73,52.3,NA
KS,"Hamilton County, Kansas",371,137,234,20075,45114,48344,NA,NA,NA,32208,1002,340,1020,224,2022,564,"Hamilton County, Kansas(6)",_,_,"Hamilton County, Kansas",*,*,**,2474,20,75,NA,NA
KS,"Harper County, Kansas",933,443,490,20077,43973,43438,NA,60417,NA,NA,2493,375,2511,324,5004,699,"Harper County, Kansas(6)",_,_,"Harper County, Kansas",53,5,stable,5817,20,77,53,NA
KS,"Harvey County, Kansas",4415,1785,2630,20079,51327,51911,NA,NA,NA,39245,15195,1596,15987,1423,31182,3019,"Harvey County, Kansas(6)",_,_,"Harvey County, Kansas",41.4,20,stable,35073,20,79,41.4,NA
KS,"Haskell County, Kansas",562,269,293,20081,56484,60306,NA,46250,NA,37067,1728,327,1622,400,3350,727,"Haskell County, Kansas(6)",_,_,"Haskell County, Kansas",*,*,**,4064,20,81,NA,NA
KS,"Hodgeman County, Kansas",88,44,44,20083,54856,54471,NA,NA,NA,54167,865,95,859,85,1724,180,"Hodgeman County, Kansas(6)",_,_,"Hodgeman County, Kansas",*,*,**,1893,20,83,NA,NA
KS,"Jackson County, Kansas",1197,414,783,20085,54077,56259,37188,27750,51339,41250,6111,488,6198,475,12309,963,"Jackson County, Kansas(6)",_,_,"Jackson County, Kansas",56.1,10,stable,13338,20,85,56.1,NA
KS,"Jefferson County, Kansas",1394,592,802,20087,57236,57274,NA,70192,NA,38750,8420,1072,8561,588,16981,1660,"Jefferson County, Kansas(6)",_,_,"Jefferson County, Kansas",47.7,12,stable,18930,20,87,47.7,NA
KS,"Jewell County, Kansas",466,200,266,20089,40553,40865,NA,42500,NA,29250,1408,98,1412,93,2820,191,"Jewell County, Kansas(6)",_,_,"Jewell County, Kansas",55.2,3,**,2970,20,89,55.2,NA
KS,"Johnson County, Kansas",34556,14939,19617,20091,76113,77708,48930,72500,90328,46167,253715,21313,268130,19380,521845,40693,"Johnson County, Kansas(6)",_,_,"Johnson County, Kansas",39.6,210,falling,580159,20,91,39.6,NA
KS,"Kearny County, Kansas",412,196,216,20093,50506,59479,NA,NA,NA,46429,1894,190,1603,189,3497,379,"Kearny County, Kansas(6)",_,_,"Kearny County, Kansas",71.7,3,**,3956,20,93,71.7,NA
KS,"Kingman County, Kansas",811,289,522,20095,50844,50812,NA,41071,NA,29135,3363,510,3365,401,6728,911,"Kingman County, Kansas(6)",_,_,"Kingman County, Kansas",26.5,3,stable,7687,20,95,26.5,NA
KS,"Kiowa County, Kansas",364,177,187,20097,43963,43628,NA,48750,NA,43889,1075,144,1155,93,2230,237,"Kiowa County, Kansas(6)",_,_,"Kiowa County, Kansas",*,*,**,2564,20,97,NA,NA
KS,"Labette County, Kansas",3651,1642,2009,20099,41439,42522,17328,36964,NA,25500,8898,1349,9121,1373,18019,2722,"Labette County, Kansas(6)",_,_,"Labette County, Kansas",56.1,16,stable,20803,20,99,56.1,NA
KS,"Lane County, Kansas",149,45,104,20101,56507,56728,NA,NA,NA,NA,741,67,805,52,1546,119,"Lane County, Kansas(6)",_,_,"Lane County, Kansas",*,*,**,1670,20,101,NA,NA
KS,"Leavenworth County, Kansas",8223,3686,4537,20103,63726,65978,49443,62292,92727,62431,32327,2740,33288,2774,65615,5514,"Leavenworth County, Kansas(6)",_,_,"Leavenworth County, Kansas",48.3,37,falling,79315,20,103,48.3,NA
KS,"Lincoln County, Kansas",333,139,194,20105,44276,43684,NA,NA,NA,18438,1345,193,1349,201,2694,394,"Lincoln County, Kansas(6)",_,_,"Lincoln County, Kansas",*,*,**,3105,20,105,NA,NA
KS,"Linn County, Kansas",1246,607,639,20107,46964,46867,56316,75441,NA,24282,4196,420,4367,475,8563,895,"Linn County, Kansas(6)",_,_,"Linn County, Kansas",65.1,10,stable,9536,20,107,65.1,NA
KS,"Logan County, Kansas",232,98,134,20109,46875,49091,NA,NA,NA,76250,1279,115,1235,124,2514,239,"Logan County, Kansas(6)",_,_,"Logan County, Kansas",*,*,**,2825,20,109,NA,NA
KS,"Lyon County, Kansas",6919,3172,3747,20111,40021,41085,NA,31442,24750,38903,13655,2404,14734,2256,28389,4660,"Lyon County, Kansas(6)",_,_,"Lyon County, Kansas",53.3,19,stable,33339,20,111,53.3,NA
KS,"McPherson County, Kansas",1993,704,1289,20113,56128,56393,NA,52039,41228,57692,13319,954,13403,941,26722,1895,"McPherson County, Kansas(6)",_,_,"McPherson County, Kansas",34.4,15,stable,28941,20,113,34.4,NA
KS,"Marion County, Kansas",1306,620,686,20115,45927,46554,45714,29559,NA,NA,5517,413,5490,528,11007,941,"Marion County, Kansas(6)",_,_,"Marion County, Kansas",26.8,5,stable,12103,20,115,26.8,NA
KS,"Marshall County, Kansas",1087,407,680,20117,45374,45465,NA,NA,NA,43542,4446,437,4569,366,9015,803,"Marshall County, Kansas(6)",_,_,"Marshall County, Kansas",37.5,6,stable,9936,20,117,37.5,NA
KS,"Meade County, Kansas",481,174,307,20119,52250,53025,NA,NA,NA,39792,1927,259,1852,218,3779,477,"Meade County, Kansas(6)",_,_,"Meade County, Kansas",*,*,**,4330,20,119,NA,NA
KS,"Miami County, Kansas",2949,1213,1736,20121,60966,61602,43971,NA,2499,55885,14560,1227,15190,1119,29750,2346,"Miami County, Kansas(6)",_,_,"Miami County, Kansas",41,15,stable,32553,20,121,41,NA
KS,"Mitchell County, Kansas",626,227,399,20123,48217,48975,NA,NA,NA,14000,2831,305,2845,162,5676,467,"Mitchell County, Kansas(6)",_,_,"Mitchell County, Kansas",45.4,5,stable,6282,20,123,45.4,NA
KS,"Montgomery County, Kansas",6303,2948,3355,20125,41083,42705,15932,37470,NA,34886,14212,2402,14815,2214,29027,4616,"Montgomery County, Kansas(6)",_,_,"Montgomery County, Kansas",64.4,30,stable,33314,20,125,64.4,NA
KS,"Morris County, Kansas",505,229,276,20127,47089,47743,NA,NA,NA,46250,2547,272,2581,269,5128,541,"Morris County, Kansas(6)",_,_,"Morris County, Kansas",51.3,5,stable,5645,20,127,51.3,NA
KS,"Morton County, Kansas",325,151,174,20129,46028,47306,NA,NA,NA,42097,1437,159,1256,162,2693,321,"Morton County, Kansas(6)",_,_,"Morton County, Kansas",*,*,**,3007,20,129,NA,NA
KS,"Nemaha County, Kansas",1129,473,656,20131,48653,49292,28523,21875,NA,53281,4754,294,4557,285,9311,579,"Nemaha County, Kansas(6)",_,_,"Nemaha County, Kansas",29.6,5,stable,10227,20,131,29.6,NA
KS,"Neosho County, Kansas",2961,1306,1655,20133,43195,43450,NA,NA,NA,24583,7189,752,7269,985,14458,1737,"Neosho County, Kansas(6)",_,_,"Neosho County, Kansas",49.7,11,stable,16346,20,133,49.7,NA
KS,"Ness County, Kansas",354,217,137,20135,44904,44778,NA,NA,NA,32788,1414,122,1381,103,2795,225,"Ness County, Kansas(6)",_,_,"Ness County, Kansas",*,*,**,3005,20,135,NA,NA
KS,"Norton County, Kansas",398,166,232,20137,47852,47542,NA,NA,NA,NA,2224,186,2154,190,4378,376,"Norton County, Kansas(6)",_,_,"Norton County, Kansas",*,*,*,5550,20,137,NA,NA
KS,"Osage County, Kansas",1997,852,1145,20139,49915,50514,NA,NA,NA,40060,7134,817,7005,918,14139,1735,"Osage County, Kansas(6)",_,_,"Osage County, Kansas",61.8,14,stable,15847,20,139,61.8,NA
KS,"Osborne County, Kansas",564,232,332,20141,40216,39844,NA,NA,NA,NA,1640,184,1669,184,3309,368,"Osborne County, Kansas(6)",_,_,"Osborne County, Kansas",*,*,*,3683,20,141,NA,NA
KS,"Ottawa County, Kansas",466,217,249,20143,52479,53021,NA,NA,NA,67596,2770,302,2607,274,5377,576,"Ottawa County, Kansas(6)",_,_,"Ottawa County, Kansas",46.4,4,**,5975,20,143,46.4,NA
KS,"Pawnee County, Kansas",464,179,285,20145,43250,43844,NA,NA,NA,NA,2766,249,2489,396,5255,645,"Pawnee County, Kansas(6)",_,_,"Pawnee County, Kansas",33.2,3,stable,6838,20,145,33.2,NA
KS,"Phillips County, Kansas",494,207,287,20147,44170,44236,NA,43750,NA,43295,2423,223,2562,175,4985,398,"Phillips County, Kansas(6)",_,_,"Phillips County, Kansas",56.3,5,**,5428,20,147,56.3,NA
KS,"Pottawatomie County, Kansas",1992,859,1133,20149,60216,60330,88780,71912,51591,41500,10062,828,10455,805,20517,1633,"Pottawatomie County, Kansas(6)",_,_,"Pottawatomie County, Kansas",39.2,9,stable,23298,20,149,39.2,NA
KS,"Pratt County, Kansas",1144,511,633,20151,49550,51250,NA,NA,NA,46894,4211,523,4352,446,8563,969,"Pratt County, Kansas(6)",_,_,"Pratt County, Kansas",46.2,7,stable,9691,20,151,46.2,NA
KS,"Rawlins County, Kansas",250,108,142,20153,41579,41480,NA,NA,NA,NA,1187,101,1118,98,2305,199,"Rawlins County, Kansas(6)",_,_,"Rawlins County, Kansas",*,*,**,2506,20,153,NA,NA
KS,"Reno County, Kansas",7457,3277,4180,20155,45288,45391,51612,50750,65750,39123,26523,3668,27232,4141,53755,7809,"Reno County, Kansas(6)",_,_,"Reno County, Kansas",51.4,45,stable,63718,20,155,51.4,NA
KS,"Republic County, Kansas",599,248,351,20157,40449,40740,NA,NA,NA,55250,2133,203,2218,154,4351,357,"Republic County, Kansas(6)",_,_,"Republic County, Kansas",49,4,stable,4725,20,157,49,NA
KS,"Rice County, Kansas",1365,641,724,20159,48460,49547,23947,46667,2499,52935,4223,745,4250,598,8473,1343,"Rice County, Kansas(6)",_,_,"Rice County, Kansas",62.7,9,rising,9977,20,159,62.7,NA
KS,"Riley County, Kansas",14922,7227,7695,20161,44437,45612,47893,22517,30675,33583,31274,2654,32321,2074,63595,4728,"Riley County, Kansas(6)",_,_,"Riley County, Kansas",45.2,20,stable,75247,20,161,45.2,NA
KS,"Rooks County, Kansas",723,367,356,20163,43558,43269,NA,NA,NA,28958,2137,288,2378,226,4515,514,"Rooks County, Kansas(6)",_,_,"Rooks County, Kansas",*,*,*,5174,20,163,NA,NA
KS,"Rush County, Kansas",292,123,169,20165,38854,39063,NA,NA,NA,NA,1432,145,1395,146,2827,291,"Rush County, Kansas(6)",_,_,"Rush County, Kansas",*,*,*,3130,20,165,NA,NA
KS,"Russell County, Kansas",885,442,443,20167,41102,41858,NA,NA,NA,38750,3127,317,3121,299,6248,616,"Russell County, Kansas(6)",_,_,"Russell County, Kansas",39.9,5,stable,7039,20,167,39.9,NA
KS,"Saline County, Kansas",8700,3648,5052,20169,47801,48491,33438,20425,75547,31574,23383,3739,24630,3181,48013,6920,"Saline County, Kansas(6)",_,_,"Saline County, Kansas",51.8,35,stable,55691,20,169,51.8,NA
KS,"Scott County, Kansas",319,104,215,20171,51850,51868,NA,NA,NA,NA,2104,261,2409,73,4513,334,"Scott County, Kansas(6)",_,_,"Scott County, Kansas",*,*,**,4964,20,171,NA,NA
KS,"Sedgwick County, Kansas",75400,34214,41186,20173,50657,53837,29097,42793,53291,36978,211273,35167,222649,30991,433922,66158,"Sedgwick County, Kansas(6)",_,_,"Sedgwick County, Kansas",50.3,251,falling,511574,20,173,50.3,NA
KS,"Seward County, Kansas",4350,1771,2579,20175,47134,47277,36429,72386,57434,44024,9273,2448,9295,2050,18568,4498,"Seward County, Kansas(6)",_,_,"Seward County, Kansas",37.1,7,stable,23152,20,175,37.1,NA
KS,"Shawnee County, Kansas",26445,12850,13595,20177,50378,52449,27617,46600,61607,40216,74433,10865,81597,8636,156030,19501,"Shawnee County, Kansas(6)",_,_,"Shawnee County, Kansas",49.9,109,falling,178725,20,177,49.9,NA
KS,"Sheridan County, Kansas",165,49,116,20179,49750,50406,NA,NA,NA,35673,1194,108,1070,130,2264,238,"Sheridan County, Kansas(6)",_,_,"Sheridan County, Kansas",*,*,**,2512,20,179,NA,NA
KS,"Sherman County, Kansas",1125,605,520,20181,39029,39757,NA,NA,NA,25873,2553,368,2754,325,5307,693,"Sherman County, Kansas(6)",_,_,"Sherman County, Kansas",51.6,5,stable,5983,20,181,51.6,NA
KS,"Smith County, Kansas",543,207,336,20183,43848,43992,NA,NA,NA,72875,1693,115,1754,120,3447,235,"Smith County, Kansas(6)",_,_,"Smith County, Kansas",61.9,4,**,3704,20,183,61.9,NA
KS,"Stafford County, Kansas",675,351,324,20185,47377,47905,NA,NA,NA,36500,1821,295,1823,273,3644,568,"Stafford County, Kansas(6)",_,_,"Stafford County, Kansas",*,*,**,4236,20,185,NA,NA
KS,"Stanton County, Kansas",113,41,72,20187,43780,52500,NA,NA,NA,32083,851,125,1027,110,1878,235,"Stanton County, Kansas(6)",_,_,"Stanton County, Kansas",*,*,**,2072,20,187,NA,NA
KS,"Stevens County, Kansas",1037,423,614,20189,55433,60795,NA,42917,NA,41719,2384,498,2327,489,4711,987,"Stevens County, Kansas(6)",_,_,"Stevens County, Kansas",*,*,**,5806,20,189,NA,NA
KS,"Sumner County, Kansas",2869,1134,1735,20191,50141,50423,NA,NA,2499,54241,10137,1312,10578,1128,20715,2440,"Sumner County, Kansas(6)",_,_,"Sumner County, Kansas",49.9,15,stable,23535,20,191,49.9,NA
KS,"Thomas County, Kansas",733,337,396,20193,48504,49375,NA,NA,NA,35096,3626,233,3656,294,7282,527,"Thomas County, Kansas(6)",_,_,"Thomas County, Kansas",*,*,*,7904,20,193,NA,NA
KS,"Trego County, Kansas",119,54,65,20195,54000,54000,NA,NA,NA,41250,1290,135,1354,99,2644,234,"Trego County, Kansas(6)",_,_,"Trego County, Kansas",*,*,**,2927,20,195,NA,NA
KS,"Wabaunsee County, Kansas",404,149,255,20197,54688,54555,NA,NA,NA,48500,3155,327,3179,233,6334,560,"Wabaunsee County, Kansas(6)",_,_,"Wabaunsee County, Kansas",*,*,**,6951,20,197,NA,NA
KS,"Wallace County, Kansas",129,54,75,20199,47279,47426,NA,NA,NA,53750,662,119,737,59,1399,178,"Wallace County, Kansas(6)",_,_,"Wallace County, Kansas",*,*,**,1518,20,199,NA,NA
KS,"Washington County, Kansas",649,265,384,20201,45159,45099,NA,NA,NA,31875,2552,262,2526,213,5078,475,"Washington County, Kansas(6)",_,_,"Washington County, Kansas",42.7,4,stable,5598,20,201,42.7,NA
KS,"Wichita County, Kansas",214,122,92,20203,57171,56711,NA,NA,NA,38000,1003,143,857,177,1860,320,"Wichita County, Kansas(6)",_,_,"Wichita County, Kansas",*,*,**,2157,20,203,NA,NA
KS,"Wilson County, Kansas",1639,813,826,20205,40306,40699,NA,31667,114250,28750,3690,733,3839,673,7529,1406,"Wilson County, Kansas(6)",_,_,"Wilson County, Kansas",36.5,5,stable,8856,20,205,36.5,NA
KS,"Woodson County, Kansas",714,328,386,20207,35787,36019,NA,NA,NA,NA,1367,222,1303,295,2670,517,"Woodson County, Kansas(6)",_,_,"Woodson County, Kansas",75.6,4,stable,3115,20,207,75.6,NA
KS,"Wyandotte County, Kansas",37963,17111,20852,20209,40113,44543,30800,32054,32917,35763,59633,19059,64007,16905,123640,35964,"Wyandotte County, Kansas(6)",_,_,"Wyandotte County, Kansas",67.4,99,stable,163369,20,209,67.4,NA
KY,"Adair County, Kentucky",3789,1677,2112,21001,33362,34163,NA,NA,NA,NA,7610,1513,8237,1191,15847,2704,"Adair County, Kentucky(7,9)",91.2,21,"Adair County, Kentucky",64.5,15,stable,19027,21,1,64.5,91.2
KY,"Allen County, Kentucky",3454,1622,1832,21003,41326,40762,NA,NA,NA,NA,8287,1643,8621,1617,16908,3260,"Allen County, Kentucky(7,9)",82.9,20,"Allen County, Kentucky",67.8,17,stable,20640,21,3,67.8,82.9
KY,"Anderson County, Kentucky",2223,1071,1152,21005,53974,54574,43250,NA,NA,NA,9563,1019,10211,858,19774,1877,"Anderson County, Kentucky(7,9)",95.1,23,"Anderson County, Kentucky",78,18,stable,21979,21,5,78,95.1
KY,"Ballard County, Kentucky",1295,521,774,21007,42244,44026,28250,9583,NA,58375,3513,513,3619,481,7132,994,"Ballard County, Kentucky(7,9)",94.3,11,"Ballard County, Kentucky",76.1,9,stable,8212,21,7,76.1,94.3
KY,"Barren County, Kentucky",8598,3891,4707,21009,38370,38803,23452,NA,163583,29718,17754,2806,19037,2579,36791,5385,"Barren County, Kentucky(7,9)",106.9,58,"Barren County, Kentucky",73,40,stable,43570,21,9,73,106.9
KY,"Bath County, Kentucky",3122,1519,1603,21011,33483,33913,21125,NA,NA,NA,5097,829,5211,745,10308,1574,"Bath County, Kentucky(7,9)",109,16,"Bath County, Kentucky",77.4,11,stable,12228,21,11,77.4,109
KY,"Bell County, Kentucky",10233,4422,5811,21013,22443,22493,17574,NA,50227,NA,11077,1888,12279,1896,23356,3784,"Bell County, Kentucky(7,9)",99.5,37,"Bell County, Kentucky",73.9,28,stable,27337,21,13,73.9,99.5
KY,"Boone County, Kentucky",10156,4171,5985,21015,66730,66614,57158,NA,75257,43333,55944,4960,58053,4777,113997,9737,"Boone County, Kentucky(7,9)",86,90,"Boone County, Kentucky",60.1,63,falling,127712,21,15,60.1,86
KY,"Bourbon County, Kentucky",3272,1367,1905,21017,45208,46782,26438,NA,NA,42330,8272,1468,8907,1125,17179,2593,"Bourbon County, Kentucky(7,9)",93.4,24,"Bourbon County, Kentucky",56.2,14,stable,20116,21,17,56.2,93.4
KY,"Boyd County, Kentucky",9500,3956,5544,21019,42319,42632,15484,NA,165114,NA,19500,2989,21652,2664,41152,5653,"Boyd County, Kentucky(7,9)",92.7,61,"Boyd County, Kentucky",65.3,43,stable,48325,21,19,65.3,92.7
KY,"Boyle County, Kentucky",4291,1972,2319,21021,39704,40278,27109,NA,NA,24010,11987,1657,13140,1313,25127,2970,"Boyle County, Kentucky(7,9)",77.6,29,"Boyle County, Kentucky",56.9,21,falling,29809,21,21,56.9,77.6
KY,"Bracken County, Kentucky",1544,695,849,21023,36327,36469,NA,NA,NA,NA,3834,355,3880,312,7714,667,"Bracken County, Kentucky(7,9)",120.6,12,"Bracken County, Kentucky",92.7,9,stable,8321,21,23,92.7,120.6
KY,"Breathitt County, Kentucky",4366,2095,2271,21025,25817,25635,NA,NA,123750,NA,5669,1065,6027,683,11696,1748,"Breathitt County, Kentucky(7,9)",105.7,18,"Breathitt County, Kentucky",73.2,13,stable,13484,21,25,73.2,105.7
KY,"Breckinridge County, Kentucky",3422,1525,1897,21027,43479,44482,16250,NA,NA,42031,8348,1409,8807,1218,17155,2627,"Breckinridge County, Kentucky(7,9)",110.2,29,"Breckinridge County, Kentucky",80,21,stable,20018,21,27,80,110.2
KY,"Bullitt County, Kentucky",7911,3531,4380,21029,55975,56590,NA,NA,54286,63177,34539,3232,36542,2294,71081,5526,"Bullitt County, Kentucky(7,9)",90.9,70,"Bullitt County, Kentucky",59.8,44,falling,78702,21,29,59.8,90.9
KY,"Butler County, Kentucky",3667,1636,2031,21031,33536,33086,NA,NA,NA,NA,5530,791,5527,772,11057,1563,"Butler County, Kentucky(7,9)",87.2,14,"Butler County, Kentucky",76.6,12,stable,12938,21,31,76.6,87.2
KY,"Caldwell County, Kentucky",2544,1119,1425,21033,42537,42894,36324,NA,NA,NA,5306,847,5982,565,11288,1412,"Caldwell County, Kentucky(7,9)",103.9,19,"Caldwell County, Kentucky",88,16,stable,12681,21,33,88,103.9
KY,"Calloway County, Kentucky",8015,3642,4373,21035,37034,38851,28405,2499,2499,19406,15956,2145,17401,2162,33357,4307,"Calloway County, Kentucky(7,9)",79.1,35,"Calloway County, Kentucky",57.1,25,stable,38343,21,35,57.1,79.1
KY,"Campbell County, Kentucky",12883,5671,7212,21037,54621,55738,19531,NA,92829,24258,39050,4835,41623,4503,80673,9338,"Campbell County, Kentucky(7,9)",94.5,93,"Campbell County, Kentucky",67.3,65,stable,92066,21,37,67.3,94.5
KY,"Carlisle County, Kentucky",970,388,582,21039,38829,38934,25357,NA,NA,82829,1999,371,2234,310,4233,681,"Carlisle County, Kentucky(7,9)",95.2,7,"Carlisle County, Kentucky",61.5,5,stable,4874,21,39,61.5,95.2
KY,"Carroll County, Kentucky",2898,1409,1489,21041,41439,42291,14891,NA,NA,23077,4547,926,4343,777,8890,1703,"Carroll County, Kentucky(7,9)",120.7,15,"Carroll County, Kentucky",69.9,9,stable,10699,21,41,69.9,120.7
KY,"Carter County, Kentucky",4682,2153,2529,21043,36696,36814,NA,NA,NA,19178,11205,2107,11721,1979,22926,4086,"Carter County, Kentucky(7,9)",103,35,"Carter County, Kentucky",73.5,25,stable,27158,21,43,73.5,103
KY,"Casey County, Kentucky",3969,1878,2091,21045,32341,32644,26607,NA,NA,NA,6323,1419,6646,1235,12969,2654,"Casey County, Kentucky(7,9)",108.6,23,"Casey County, Kentucky",98.5,21,stable,15808,21,45,98.5,108.6
KY,"Christian County, Kentucky",13576,5438,8138,21047,39521,42874,26444,22969,55417,28214,26112,4412,30171,4471,56283,8883,"Christian County, Kentucky(7,9)",84.9,53,"Christian County, Kentucky",62.4,39,falling,73309,21,47,62.4,84.9
KY,"Clark County, Kentucky",5401,2194,3207,21049,47959,48616,27044,NA,98438,27404,15217,1994,16084,1937,31301,3931,"Clark County, Kentucky(7,9)",93.4,40,"Clark County, Kentucky",67.4,29,stable,35757,21,49,67.4,93.4
KY,"Clay County, Kentucky",7732,3730,4002,21051,21549,21444,23625,57500,NA,NA,8527,1318,8879,920,17406,2238,"Clay County, Kentucky(7,9)",118.6,28,"Clay County, Kentucky",96.5,22,stable,21013,21,51,96.5,118.6
KY,"Clinton County, Kentucky",2435,1078,1357,21053,28025,28225,NA,NA,NA,16786,4184,760,4569,523,8753,1283,"Clinton County, Kentucky(7,9)",111.7,16,"Clinton County, Kentucky",80.5,11,stable,10174,21,53,80.5,111.7
KY,"Crittenden County, Kentucky",1974,950,1024,21055,35316,35693,14091,NA,NA,NA,3763,740,3854,671,7617,1411,"Crittenden County, Kentucky(7,9)",76.6,10,"Crittenden County, Kentucky",78.8,10,stable,9183,21,55,78.8,76.6
KY,"Cumberland County, Kentucky",1682,652,1030,21057,32019,32294,21786,NA,NA,NA,2711,582,2831,595,5542,1177,"Cumberland County, Kentucky(7,9)",96.4,10,"Cumberland County, Kentucky",67.9,7,stable,6759,21,57,67.9,96.4
KY,"Daviess County, Kentucky",14948,6723,8225,21059,45989,47450,24767,26250,37083,27500,41744,4990,45640,4058,87384,9048,"Daviess County, Kentucky(7,9)",110.2,130,"Daviess County, Kentucky",78.1,92,stable,99259,21,59,78.1,110.2
KY,"Edmonson County, Kentucky",2296,971,1325,21061,41710,41794,NA,NA,NA,NA,5339,723,5522,424,10861,1147,"Edmonson County, Kentucky(7,9)",85.6,14,"Edmonson County, Kentucky",70.5,12,stable,12007,21,61,70.5,85.6
KY,"Elliott County, Kentucky",2079,1023,1056,21063,28224,28257,NA,NA,NA,NA,2965,413,2916,409,5881,822,"Elliott County, Kentucky(7,9)",73.8,8,"Elliott County, Kentucky",58.5,6,stable,7648,21,63,58.5,73.8
KY,"Estill County, Kentucky",4199,1957,2242,21065,29770,29778,NA,NA,NA,NA,5958,1112,6469,811,12427,1923,"Estill County, Kentucky(7,9)",124.6,24,"Estill County, Kentucky",83.5,16,stable,14375,21,65,83.5,124.6
KY,"Fayette County, Kentucky",55900,26117,29783,21067,49778,55636,28366,35234,65154,34907,128848,18757,140094,15307,268942,34064,"Fayette County, Kentucky(7,9)",74,206,"Fayette County, Kentucky",52.2,145,falling,314488,21,67,52.2,74
KY,"Fleming County, Kentucky",2907,1232,1675,21069,35469,35681,NA,NA,NA,NA,5735,1444,6113,1252,11848,2696,"Fleming County, Kentucky(7,9)",90.5,16,"Fleming County, Kentucky",61.1,11,stable,14637,21,69,61.1,90.5
KY,"Floyd County, Kentucky",11441,5471,5970,21071,30096,30073,NA,53929,250001,NA,15672,3017,17076,2325,32748,5342,"Floyd County, Kentucky(7,9)",149.4,73,"Floyd County, Kentucky",98.7,47,stable,37756,21,71,98.7,149.4
KY,"Franklin County, Kentucky",6990,3195,3795,21073,47964,50529,38305,NA,64569,27440,20632,3089,23049,2051,43681,5140,"Franklin County, Kentucky(7,9)",93,56,"Franklin County, Kentucky",75.9,45,stable,50375,21,73,75.9,93
KY,"Fulton County, Kentucky",1641,763,878,21075,28359,33682,15731,NA,NA,27250,2477,379,2656,480,5133,859,"Fulton County, Kentucky(7,9)",112.4,11,"Fulton County, Kentucky",88.9,9,stable,6238,21,75,88.9,112.4
KY,"Gallatin County, Kentucky",1294,589,705,21077,48370,49114,NA,NA,NA,40139,3653,584,3569,651,7222,1235,"Gallatin County, Kentucky(7,9)",104,9,"Gallatin County, Kentucky",83.8,8,stable,8636,21,77,83.8,104
KY,"Garrard County, Kentucky",3653,1729,1924,21079,44243,44417,30966,NA,NA,37206,7132,1188,7409,1144,14541,2332,"Garrard County, Kentucky(7,9)",97.8,21,"Garrard County, Kentucky",79.6,16,rising,17237,21,79,79.6,97.8
KY,"Grant County, Kentucky",4445,1914,2531,21081,44824,44193,NA,NA,NA,85060,10735,1268,10822,1419,21557,2687,"Grant County, Kentucky(7,9)",95.8,23,"Grant County, Kentucky",64.4,15,stable,24757,21,81,64.4,95.8
KY,"Graves County, Kentucky",6342,2715,3627,21083,39530,41790,16333,NA,NA,38474,15937,2107,16799,2228,32736,4335,"Graves County, Kentucky(7,9)",85.8,43,"Graves County, Kentucky",72.8,36,stable,37421,21,83,72.8,85.8
KY,"Grayson County, Kentucky",6119,2731,3388,21085,35030,35438,NA,NA,NA,NA,10962,1730,11130,1779,22092,3509,"Grayson County, Kentucky(7,9)",129.7,43,"Grayson County, Kentucky",87.9,28,rising,26221,21,85,87.9,129.7
KY,"Green County, Kentucky",2216,1047,1169,21087,34982,36113,NA,NA,NA,NA,4766,672,5029,568,9795,1240,"Green County, Kentucky(7,9)",86.4,14,"Green County, Kentucky",68.4,11,stable,11010,21,87,68.4,86.4
KY,"Greenup County, Kentucky",6355,2848,3507,21089,45370,45577,NA,NA,131136,71176,15041,2504,16463,2045,31504,4549,"Greenup County, Kentucky(7,9)",107.4,54,"Greenup County, Kentucky",71.9,36,stable,36068,21,89,71.9,107.4
KY,"Hancock County, Kentucky",1360,654,706,21091,50476,50420,58594,NA,NA,NA,4054,375,3828,357,7882,732,"Hancock County, Kentucky(7,9)",81.9,9,"Hancock County, Kentucky",81.4,9,stable,8692,21,91,81.4,81.9
KY,"Hardin County, Kentucky",14886,5818,9068,21093,50765,50156,55642,NA,64167,51656,43690,5003,48278,4751,91968,9754,"Hardin County, Kentucky(7,9)",101.5,104,"Hardin County, Kentucky",69.3,71,stable,106439,21,93,69.3,101.5
KY,"Harlan County, Kentucky",8661,3763,4898,21095,25814,25892,23417,15833,250001,NA,11532,2065,12330,1993,23862,4058,"Harlan County, Kentucky(7,9)",127.6,48,"Harlan County, Kentucky",95.3,34,stable,27703,21,95,95.3,127.6
KY,"Harrison County, Kentucky",4069,1749,2320,21097,35681,36803,NA,NA,NA,30259,7525,1511,8119,1289,15644,2800,"Harrison County, Kentucky(7,9)",95.8,23,"Harrison County, Kentucky",65.1,15,stable,18763,21,97,65.1,95.8
KY,"Hart County, Kentucky",4507,2082,2425,21099,34774,35542,20000,NA,NA,41806,7399,1564,7956,1268,15355,2832,"Hart County, Kentucky(7,9)",114.5,27,"Hart County, Kentucky",90.2,21,stable,18454,21,99,90.2,114.5
KY,"Henderson County, Kentucky",8602,3810,4792,21101,41036,42762,24167,NA,59318,36625,19221,2564,21419,2224,40640,4788,"Henderson County, Kentucky(7,9)",97.8,54,"Henderson County, Kentucky",67.5,38,stable,46407,21,101,67.5,97.8
KY,"Henry County, Kentucky",2798,1226,1572,21103,46495,46990,29773,NA,NA,NA,6875,815,6811,876,13686,1691,"Henry County, Kentucky(7,9)",109.3,21,"Henry County, Kentucky",89.3,17,stable,15620,21,103,89.3,109.3
KY,"Hickman County, Kentucky",675,284,391,21105,41218,42468,23250,NA,NA,NA,1822,351,2083,264,3905,615,"Hickman County, Kentucky(7,9)",80,6,"Hickman County, Kentucky",66.4,5,stable,4612,21,105,66.4,80
KY,"Hopkins County, Kentucky",7799,3301,4498,21107,42346,43829,28750,NA,NA,51458,19300,2689,20665,2855,39965,5544,"Hopkins County, Kentucky(7,9)",89.9,55,"Hopkins County, Kentucky",66.6,41,stable,46222,21,107,66.6,89.9
KY,"Jackson County, Kentucky",4163,1963,2200,21109,29826,29925,NA,NA,NA,NA,5322,1225,5727,931,11049,2156,"Jackson County, Kentucky(7,9)",118.3,20,"Jackson County, Kentucky",104.6,17,stable,13352,21,109,104.6,118.3
KY,"Jefferson County, Kentucky",121683,54397,67286,21111,48695,54330,29245,50214,64884,39010,317681,42529,350615,36744,668296,79273,"Jefferson County, Kentucky(7,9)",89.6,759,"Jefferson County, Kentucky",60.5,512,falling,763623,21,111,60.5,89.6
KY,"Jessamine County, Kentucky",9190,4128,5062,21113,50558,51302,32083,43750,NA,30809,21214,2952,22975,2609,44189,5561,"Jessamine County, Kentucky(7,9)",89,44,"Jessamine County, Kentucky",59.7,29,falling,51961,21,113,59.7,89
KY,"Johnson County, Kentucky",5977,2721,3256,21115,35570,35482,NA,NA,111250,2499,9812,1282,10624,1189,20436,2471,"Johnson County, Kentucky(7,9)",113,33,"Johnson County, Kentucky",92.5,27,stable,23175,21,115,92.5,113
KY,"Kenton County, Kentucky",23432,10164,13268,21117,54296,56285,24928,18688,53750,45236,70758,8846,74031,7822,144789,16668,"Kenton County, Kentucky(7,9)",90.3,145,"Kenton County, Kentucky",65,102,stable,165012,21,117,65,90.3
KY,"Knott County, Kentucky",4308,1935,2373,21119,30411,30757,23333,NA,NA,NA,6791,1117,6837,1073,13628,2190,"Knott County, Kentucky(7,9)",116.1,23,"Knott County, Kentucky",85.9,17,stable,15693,21,119,85.9,116.1
KY,"Knox County, Kentucky",10093,4551,5542,21121,26599,26499,38750,NA,NA,33526,13099,2244,14164,1956,27263,4200,"Knox County, Kentucky(7,9)",125,50,"Knox County, Kentucky",85.9,33,stable,31730,21,121,85.9,125
KY,"Larue County, Kentucky",2460,1058,1402,21123,38578,39216,33631,NA,NA,NA,5839,934,6563,531,12402,1465,"Larue County, Kentucky(7,9)",74.6,14,"Larue County, Kentucky",60.6,11,stable,14241,21,123,60.6,74.6
KY,"Laurel County, Kentucky",13588,6216,7372,21125,36020,35971,NA,26071,60405,42661,24302,4516,26170,4023,50472,8539,"Laurel County, Kentucky(7,9)",89.1,61,"Laurel County, Kentucky",74.4,50,stable,60094,21,125,74.4,89.1
KY,"Lawrence County, Kentucky",3548,1619,1929,21127,35935,36222,NA,NA,NA,63224,7013,812,6685,1199,13698,2011,"Lawrence County, Kentucky(7,9)",113.9,22,"Lawrence County, Kentucky",85.1,16,stable,15745,21,127,85.1,113.9
KY,"Lee County, Kentucky",2003,952,1051,21129,22698,22759,NA,NA,NA,NA,2586,375,2853,480,5439,855,"Lee County, Kentucky(7,9)",117.7,11,"Lee County, Kentucky",90.8,9,stable,6752,21,129,90.8,117.7
KY,"Leslie County, Kentucky",3051,1360,1691,21131,25872,26399,NA,NA,NA,NA,4705,562,4739,743,9444,1305,"Leslie County, Kentucky(7,9)",151.8,22,"Leslie County, Kentucky",110.3,16,stable,10711,21,131,110.3,151.8
KY,"Letcher County, Kentucky",6614,3158,3456,21133,30333,30367,NA,NA,NA,NA,10039,1495,10330,1616,20369,3111,"Letcher County, Kentucky(7,9)",118.5,37,"Letcher County, Kentucky",96.1,29,stable,23123,21,133,96.1,118.5
KY,"Lewis County, Kentucky",4151,1885,2266,21135,28630,28691,NA,NA,NA,NA,5802,997,5818,1025,11620,2022,"Lewis County, Kentucky(7,9)",112.6,19,"Lewis County, Kentucky",84.1,14,stable,13682,21,135,84.1,112.6
KY,"Lincoln County, Kentucky",6039,2656,3383,21137,37139,37109,36797,NA,NA,125194,9829,1898,10872,1688,20701,3586,"Lincoln County, Kentucky(7,9)",98.5,31,"Lincoln County, Kentucky",71.6,22,stable,24463,21,137,71.6,98.5
KY,"Livingston County, Kentucky",1362,518,844,21139,42171,41909,NA,NA,NA,NA,4161,471,4367,333,8528,804,"Livingston County, Kentucky(7,9)",113.1,16,"Livingston County, Kentucky",81.6,12,stable,9316,21,139,81.6,113.1
KY,"Logan County, Kentucky",5103,2411,2692,21141,38570,40257,18370,NA,NA,NA,11222,1890,11565,1903,22787,3793,"Logan County, Kentucky(7,9)",103.5,36,"Logan County, Kentucky",77.8,26,stable,26910,21,141,77.8,103.5
KY,"Lyon County, Kentucky",1002,340,662,21143,46931,46921,NA,NA,NA,NA,3120,448,3167,326,6287,774,"Lyon County, Kentucky(7,9)",86.4,12,"Lyon County, Kentucky",59.5,8,stable,8306,21,143,59.5,86.4
KY,"McCracken County, Kentucky",10763,4614,6149,21145,44067,46536,25146,NA,95455,37162,27284,3471,30304,3202,57588,6673,"McCracken County, Kentucky(7,9)",80.9,72,"McCracken County, Kentucky",55.6,49,falling,65018,21,145,55.6,80.9
KY,"McCreary County, Kentucky",6723,3259,3464,21147,19328,19340,NA,NA,NA,NA,7222,1104,7267,829,14489,1933,"McCreary County, Kentucky(7,9)",157.5,31,"McCreary County, Kentucky",111.1,22,rising,17878,21,147,111.1,157.5
KY,"McLean County, Kentucky",1983,1026,957,21149,40770,41250,53250,NA,NA,31250,4194,482,4270,470,8464,952,"McLean County, Kentucky(7,9)",101.7,14,"McLean County, Kentucky",68.1,9,stable,9512,21,149,68.1,101.7
KY,"Madison County, Kentucky",16792,7821,8971,21151,42390,43664,20463,NA,47132,28967,36288,4892,39492,4355,75780,9247,"Madison County, Kentucky(7,9)",91.6,76,"Madison County, Kentucky",73.8,60,stable,87824,21,151,73.8,91.6
KY,"Magoffin County, Kentucky",3672,1659,2013,21153,28500,28467,NA,NA,NA,NA,5506,977,5635,760,11141,1737,"Magoffin County, Kentucky(7,9)",109.7,16,"Magoffin County, Kentucky",73,10,stable,12808,21,153,73,109.7
KY,"Marion County, Kentucky",3784,1646,2138,21155,38826,40385,22004,NA,56765,36354,8105,1031,8714,824,16819,1855,"Marion County, Kentucky(7,9)",100.8,22,"Marion County, Kentucky",69.1,15,stable,19365,21,155,69.1,100.8
KY,"Marshall County, Kentucky",3287,1524,1763,21157,45212,45610,NA,NA,NA,41932,13550,1520,14546,1045,28096,2565,"Marshall County, Kentucky(7,9)",82.9,40,"Marshall County, Kentucky",60.9,29,stable,31101,21,157,60.9,82.9
KY,"Martin County, Kentucky",3896,1753,2143,21159,25795,25940,NA,NA,NA,NA,4729,908,4720,774,9449,1682,"Martin County, Kentucky(7,9)",145.1,20,"Martin County, Kentucky",109.1,14,stable,12307,21,159,109.1,145.1
KY,"Mason County, Kentucky",3087,1549,1538,21161,38824,40041,20365,NA,NA,NA,7261,1066,7844,818,15105,1884,"Mason County, Kentucky(7,9)",123.7,27,"Mason County, Kentucky",86.6,19,stable,17099,21,161,86.6,123.7
KY,"Meade County, Kentucky",4810,2187,2623,21163,49884,50524,39609,NA,NA,57383,12110,1836,12590,1681,24700,3517,"Meade County, Kentucky(7,9)",118.1,33,"Meade County, Kentucky",87,24,stable,27924,21,163,87,118.1
KY,"Menifee County, Kentucky",1851,917,934,21165,31503,32037,NA,NA,NA,NA,2721,532,2695,318,5416,850,"Menifee County, Kentucky(7,9)",124.6,11,"Menifee County, Kentucky",106,9,stable,6358,21,165,106,124.6
KY,"Mercer County, Kentucky",3862,1709,2153,21167,42083,42638,41429,NA,NA,69500,9137,1331,9758,955,18895,2286,"Mercer County, Kentucky(7,9)",93.3,27,"Mercer County, Kentucky",67.2,19,stable,21407,21,167,67.2,93.3
KY,"Metcalfe County, Kentucky",2158,932,1226,21169,32294,33458,17292,NA,NA,30893,4014,895,4198,784,8212,1679,"Metcalfe County, Kentucky(7,9)",107.7,15,"Metcalfe County, Kentucky",84,11,stable,9909,21,169,84,107.7
KY,"Monroe County, Kentucky",2937,1363,1574,21171,31045,30870,39539,NA,NA,31442,4672,576,4805,542,9477,1118,"Monroe County, Kentucky(7,9)",106.8,16,"Monroe County, Kentucky",84.3,12,stable,10667,21,171,84.3,106.8
KY,"Montgomery County, Kentucky",6956,3141,3815,21173,39275,39172,29079,NA,NA,NA,11234,1995,11766,1813,23000,3808,"Montgomery County, Kentucky(7,9)",94.8,29,"Montgomery County, Kentucky",68.7,21,stable,27608,21,173,68.7,94.8
KY,"Morgan County, Kentucky",3249,1464,1785,21175,29707,29946,NA,NA,NA,NA,5158,690,5295,629,10453,1319,"Morgan County, Kentucky(7,9)",98.9,16,"Morgan County, Kentucky",81.5,13,stable,13275,21,175,81.5,98.9
KY,"Muhlenberg County, Kentucky",6000,2750,3250,21177,38961,39846,22715,NA,NA,NA,12821,2172,13643,1647,26464,3819,"Muhlenberg County, Kentucky(7,9)",102.6,42,"Muhlenberg County, Kentucky",77.3,32,stable,31183,21,177,77.3,102.6
KY,"Nelson County, Kentucky",7072,3347,3725,21179,49298,50470,28939,25833,55962,11462,19866,2005,20379,2020,40245,4025,"Nelson County, Kentucky(7,9)",90.4,42,"Nelson County, Kentucky",64.2,30,stable,45126,21,179,64.2,90.4
KY,"Nicholas County, Kentucky",1624,754,870,21181,36097,36763,23750,NA,NA,NA,2885,545,2979,560,5864,1105,"Nicholas County, Kentucky(7,9)",106.5,10,"Nicholas County, Kentucky",89.6,8,stable,7131,21,181,89.6,106.5
KY,"Ohio County, Kentucky",5208,2466,2742,21183,40189,39814,NA,NA,NA,44250,10653,1198,10556,1345,21209,2543,"Ohio County, Kentucky(7,9)",124.8,38,"Ohio County, Kentucky",94.6,28,stable,24216,21,183,94.6,124.8
KY,"Oldham County, Kentucky",3503,1271,2232,21185,85452,85894,81250,65690,167344,49375,27429,1803,28212,1375,55641,3178,"Oldham County, Kentucky(7,9)",77.2,43,"Oldham County, Kentucky",51.6,27,stable,64875,21,185,51.6,77.2
KY,"Owen County, Kentucky",1780,810,970,21187,41934,42342,36574,NA,NA,35417,4806,448,4930,508,9736,956,"Owen County, Kentucky(7,9)",91.2,12,"Owen County, Kentucky",50.6,7,stable,10730,21,187,50.6,91.2
KY,"Owsley County, Kentucky",1710,810,900,21189,20985,20618,NA,NA,NA,NA,1879,247,2108,300,3987,547,"Owsley County, Kentucky(7,9)",148.1,9,"Owsley County, Kentucky",118.5,8,stable,4461,21,189,118.5,148.1
KY,"Pendleton County, Kentucky",2188,875,1313,21191,48353,49368,NA,NA,NA,93693,6614,595,6570,639,13184,1234,"Pendleton County, Kentucky(7,9)",97.9,16,"Pendleton County, Kentucky",67.4,11,stable,14408,21,191,67.4,97.9
KY,"Perry County, Kentucky",6894,2903,3991,21193,32667,31911,93000,NA,NA,NA,11544,1921,11982,1944,23526,3865,"Perry County, Kentucky(7,9)",139.7,49,"Perry County, Kentucky",125.6,43,stable,27565,21,193,125.6,139.7
KY,"Pike County, Kentucky",14256,6146,8110,21195,33183,32965,41821,NA,NA,30147,26905,3723,28765,3303,55670,7026,"Pike County, Kentucky(7,9)",123,98,"Pike County, Kentucky",85.4,67,stable,61792,21,195,85.4,123
KY,"Powell County, Kentucky",3392,1361,2031,21197,29736,30476,NA,NA,NA,16688,5131,829,5551,714,10682,1543,"Powell County, Kentucky(7,9)",152.9,23,"Powell County, Kentucky",125.3,18,stable,12269,21,197,125.3,152.9
KY,"Pulaski County, Kentucky",16497,7900,8597,21199,34790,34838,27907,77782,43906,18510,26787,3975,28664,3411,55451,7386,"Pulaski County, Kentucky(7,9)",93.6,80,"Pulaski County, Kentucky",74.7,63,stable,63782,21,199,74.7,93.6
KY,"Robertson County, Kentucky",473,215,258,21201,31741,31830,NA,NA,NA,NA,1004,78,946,119,1950,197,"Robertson County, Kentucky(7,9)",111.8,4,"Robertson County, Kentucky",*,*,**,2138,21,201,NA,111.8
KY,"Rockcastle County, Kentucky",4105,1907,2198,21203,31555,31778,NA,NA,NA,NA,7221,929,7651,843,14872,1772,"Rockcastle County, Kentucky(7,9)",118.1,25,"Rockcastle County, Kentucky",89.2,19,stable,16942,21,203,89.2,118.1
KY,"Rowan County, Kentucky",5410,2340,3070,21205,36860,35812,41224,NA,NA,NA,9643,1561,10476,1707,20119,3268,"Rowan County, Kentucky(7,9)",92.4,22,"Rowan County, Kentucky",69.6,16,stable,23892,21,205,69.6,92.4
KY,"Russell County, Kentucky",4475,2055,2420,21207,30720,30930,41500,NA,NA,NA,7313,1270,7645,1297,14958,2567,"Russell County, Kentucky(7,9)",102.4,25,"Russell County, Kentucky",84.1,21,stable,17662,21,207,84.1,102.4
KY,"Scott County, Kentucky",5332,2152,3180,21209,63027,65456,40868,NA,74625,34120,22340,2276,22960,2365,45300,4641,"Scott County, Kentucky(7,9)",87.3,37,"Scott County, Kentucky",59.5,24,falling,52420,21,209,59.5,87.3
KY,"Shelby County, Kentucky",5566,2671,2895,21211,60324,61765,40270,NA,NA,28833,18124,3024,19538,2289,37662,5313,"Shelby County, Kentucky(7,9)",76.6,36,"Shelby County, Kentucky",47.8,22,falling,45632,21,211,47.8,76.6
KY,"Simpson County, Kentucky",3473,1486,1987,21213,39679,45173,25527,NA,NA,8657,7182,1324,7973,907,15155,2231,"Simpson County, Kentucky(7,9)",106.5,22,"Simpson County, Kentucky",81.7,17,stable,18006,21,213,81.7,106.5
KY,"Spencer County, Kentucky",1466,577,889,21215,63000,63492,91140,NA,NA,60577,8119,615,8069,651,16188,1266,"Spencer County, Kentucky(7,9)",84.8,15,"Spencer County, Kentucky",59,10,stable,17894,21,215,59,84.8
KY,"Taylor County, Kentucky",5658,2390,3268,21217,33340,33879,25887,NA,NA,NA,9975,1923,11125,1615,21100,3538,"Taylor County, Kentucky(7,9)",100.2,32,"Taylor County, Kentucky",81.6,26,stable,25420,21,217,81.6,100.2
KY,"Todd County, Kentucky",2277,927,1350,21219,40497,42892,29779,NA,NA,NA,4872,1197,4982,1241,9854,2438,"Todd County, Kentucky(7,9)",83.1,12,"Todd County, Kentucky",65.1,9,stable,12531,21,219,65.1,83.1
KY,"Trigg County, Kentucky",2500,1030,1470,21221,44083,45793,23917,NA,NA,57692,5665,1274,6222,1005,11887,2279,"Trigg County, Kentucky(7,9)",94.6,20,"Trigg County, Kentucky",80.6,17,stable,14233,21,221,80.6,94.6
KY,"Trimble County, Kentucky",1486,737,749,21223,47409,47091,NA,NA,NA,51810,3727,636,3934,486,7661,1122,"Trimble County, Kentucky(7,9)",113.2,12,"Trimble County, Kentucky",91.9,9,stable,8769,21,223,91.9,113.2
KY,"Union County, Kentucky",4091,2171,1920,21225,40120,41385,18750,NA,NA,41250,6386,1340,6497,760,12883,2100,"Union County, Kentucky(7,9)",106.4,17,"Union County, Kentucky",78.2,13,stable,15050,21,225,78.2,106.4
KY,"Warren County, Kentucky",21047,9159,11888,21227,44911,48292,31564,58558,38750,35335,49575,7636,54292,6175,103867,13811,"Warren County, Kentucky(7,9)",91.3,100,"Warren County, Kentucky",65.5,70,stable,122851,21,227,65.5,91.3
KY,"Washington County, Kentucky",2034,969,1065,21229,40976,42935,34429,NA,NA,12222,5190,641,5345,609,10535,1250,"Washington County, Kentucky(7,9)",80.5,12,"Washington County, Kentucky",60.6,9,stable,12063,21,229,60.6,80.5
KY,"Wayne County, Kentucky",5477,2505,2972,21231,28573,29326,NA,NA,NA,13966,8652,1393,9154,1148,17806,2541,"Wayne County, Kentucky(7,9)",101.7,28,"Wayne County, Kentucky",79.5,22,stable,20464,21,231,79.5,101.7
KY,"Webster County, Kentucky",2296,1117,1179,21233,38917,39085,36806,NA,NA,31528,5656,845,5850,713,11506,1558,"Webster County, Kentucky(7,9)",109.1,19,"Webster County, Kentucky",73.7,13,stable,13170,21,233,73.7,109.1
KY,"Whitley County, Kentucky",8871,4030,4841,21235,31014,31014,16346,102778,NA,NA,14768,2377,15823,2205,30591,4582,"Whitley County, Kentucky(7,9)",122.4,50,"Whitley County, Kentucky",95.6,39,stable,36129,21,235,95.6,122.4
KY,"Wolfe County, Kentucky",3058,1537,1521,21237,20504,20818,NA,NA,NA,NA,3089,443,3194,410,6283,853,"Wolfe County, Kentucky(7,9)",118.3,11,"Wolfe County, Kentucky",77.6,7,stable,7259,21,237,77.6,118.3
KY,"Woodford County, Kentucky",3259,1279,1980,21239,58750,60568,37000,NA,NA,33803,10802,1350,12086,961,22888,2311,"Woodford County, Kentucky(7,9)",68.2,20,"Woodford County, Kentucky",51.9,15,stable,25793,21,239,51.9,68.2
LA,"Acadia Parish, Louisiana",12539,4702,7837,22001,37649,43239,20742,NA,NA,30893,25052,4501,26321,5380,51373,9881,"Acadia Parish, Louisiana(7,9)",79.6,53,"Acadia Parish, Louisiana",68.6,46,stable,62577,22,1,68.6,79.6
LA,"Allen Parish, Louisiana",3501,1568,1933,22003,40948,43537,25798,43095,NA,46250,9085,1517,9271,1456,18356,2973,"Allen Parish, Louisiana(7,9)",71.2,19,"Allen Parish, Louisiana",58.4,16,stable,25683,22,3,58.4,71.2
LA,"Ascension Parish, Louisiana",13447,5551,7896,22005,70551,75232,49888,NA,70755,56400,49740,6573,51245,6347,100985,12920,"Ascension Parish, Louisiana(7,9)",68.6,63,"Ascension Parish, Louisiana",58.8,51,stable,119455,22,5,58.8,68.6
LA,"Assumption Parish, Louisiana",3643,1673,1970,22007,49167,60572,24904,NA,NA,33185,9365,1730,10035,1732,19400,3462,"Assumption Parish, Louisiana(7,9)",77.8,21,"Assumption Parish, Louisiana",62.9,17,stable,22842,22,7,62.9,77.8
LA,"Avoyelles Parish, Louisiana",8750,3408,5342,22009,33739,39339,22760,NA,NA,NA,14267,3471,16338,3711,30605,7182,"Avoyelles Parish, Louisiana(7,9)",85.2,42,"Avoyelles Parish, Louisiana",66.7,33,stable,41103,22,9,66.7,85.2
LA,"Beauregard Parish, Louisiana",7137,3103,4034,22011,45969,49349,26719,64375,80493,NA,14324,3286,14852,2707,29176,5993,"Beauregard Parish, Louisiana(7,9)",76.4,30,"Beauregard Parish, Louisiana",59.5,23,stable,36462,22,11,59.5,76.4
LA,"Bienville Parish, Louisiana",3754,1397,2357,22013,32876,45332,21335,NA,NA,NA,5355,1163,6032,1103,11387,2266,"Bienville Parish, Louisiana(7,9)",82,16,"Bienville Parish, Louisiana",63.3,12,stable,13786,22,13,63.3,82
LA,"Bossier Parish, Louisiana",17303,7402,9901,22015,52892,59888,31217,70060,53825,53147,49219,7780,53840,7722,103059,15502,"Bossier Parish, Louisiana(7,9)",75.3,91,"Bossier Parish, Louisiana",54.1,65,falling,125175,22,15,54.1,75.3
LA,"Caddo Parish, Louisiana",53752,23393,30359,22017,41234,57236,28614,26875,49009,39948,98254,19517,111467,20545,209721,40062,"Caddo Parish, Louisiana(7,9)",69,201,"Caddo Parish, Louisiana",54.8,159,falling,251460,22,17,54.8,69
LA,"Calcasieu Parish, Louisiana",32864,13822,19042,22019,45312,52272,28838,60859,57054,44375,78600,15365,84661,14896,163261,30261,"Calcasieu Parish, Louisiana(7,9)",68.4,145,"Calcasieu Parish, Louisiana",58.1,121,falling,198788,22,19,58.1,68.4
LA,"Caldwell Parish, Louisiana",2053,876,1177,22021,33294,37833,15453,NA,NA,21190,3588,1273,3742,909,7330,2182,"Caldwell Parish, Louisiana(7,9)",95.2,12,"Caldwell Parish, Louisiana",76.8,10,stable,9993,22,21,76.8,95.2
LA,"Cameron Parish, Louisiana",650,317,333,22023,64231,64885,NA,NA,NA,NA,2885,375,3098,336,5983,711,"Cameron Parish, Louisiana(7,9)",64.1,5,"Cameron Parish, Louisiana",42.4,3,**,6817,22,23,42.4,64.1
LA,"Catahoula Parish, Louisiana",1890,872,1018,22025,34904,44702,17963,NA,NA,NA,3492,1086,3512,1194,7004,2280,"Catahoula Parish, Louisiana(7,9)",93,12,"Catahoula Parish, Louisiana",66.1,8,stable,10147,22,25,66.1,93
LA,"Claiborne Parish, Louisiana",4058,2023,2035,22027,32072,48579,17567,54167,NA,NA,6309,1419,5875,1103,12184,2522,"Claiborne Parish, Louisiana(7,9)",69.5,15,"Claiborne Parish, Louisiana",44.2,10,stable,16295,22,27,44.2,69.5
LA,"Concordia Parish, Louisiana",5598,2400,3198,22029,29654,43488,16636,NA,NA,NA,6436,2106,6914,2963,13350,5069,"Concordia Parish, Louisiana(7,9)",76.7,19,"Concordia Parish, Louisiana",59.6,15,stable,20142,22,29,59.6,76.7
LA,"De Soto Parish, Louisiana",7059,3061,3998,22031,41468,51319,22397,61167,NA,NA,10910,1898,11889,2111,22799,4009,"De Soto Parish, Louisiana(7,9)",80.7,27,"De Soto Parish, Louisiana",52.7,18,stable,27052,22,31,52.7,80.7
LA,"East Baton Rouge Parish, Louisiana",85254,37081,48173,22033,49285,66598,34646,40682,58869,50208,182247,29615,203061,26795,385308,56410,"East Baton Rouge Parish, Louisiana(7,9)",56.4,240,"East Baton Rouge Parish, Louisiana",46.9,199,falling,446753,22,33,46.9,56.4
LA,"East Carroll Parish, Louisiana",2903,1374,1529,22035,21099,42083,16364,NA,NA,NA,2184,704,2549,627,4733,1331,"East Carroll Parish, Louisiana(7,9)",98,8,"East Carroll Parish, Louisiana",72.6,6,stable,7307,22,35,72.6,98
LA,"East Feliciana Parish, Louisiana",3317,1569,1748,22037,45520,54260,33384,NA,NA,NA,7029,1171,7838,1130,14867,2301,"East Feliciana Parish, Louisiana(7,9)",61.1,15,"East Feliciana Parish, Louisiana",60.4,14,stable,19696,22,37,60.4,61.1
LA,"Evangeline Parish, Louisiana",8373,3718,4655,22039,30009,41474,14524,NA,NA,20650,12886,2366,14036,2317,26922,4683,"Evangeline Parish, Louisiana(7,9)",81.8,30,"Evangeline Parish, Louisiana",70.6,26,stable,33743,22,39,70.6,81.8
LA,"Franklin Parish, Louisiana",5847,2294,3553,22041,30275,36693,17648,NA,NA,NA,6763,2057,8079,2208,14842,4265,"Franklin Parish, Louisiana(7,9)",77.2,21,"Franklin Parish, Louisiana",47.9,13,stable,20410,22,41,47.9,77.2
LA,"Grant Parish, Louisiana",3460,1459,2001,22043,39914,41059,21862,54125,NA,NA,7766,1456,8385,1330,16151,2786,"Grant Parish, Louisiana(7,9)",100.8,24,"Grant Parish, Louisiana",71.7,16,stable,22343,22,43,71.7,100.8
LA,"Iberia Parish, Louisiana",14277,6094,8183,22045,45261,54047,30554,70588,66711,46821,29216,6262,31899,5736,61115,11998,"Iberia Parish, Louisiana(7,9)",78.2,60,"Iberia Parish, Louisiana",66.3,50,falling,74103,22,45,66.3,78.2
LA,"Iberville Parish, Louisiana",5612,2473,3139,22047,45117,59344,33257,NA,NA,NA,12326,2175,13307,1618,25633,3793,"Iberville Parish, Louisiana(7,9)",92.2,34,"Iberville Parish, Louisiana",67,24,stable,33095,22,47,67,92.2
LA,"Jackson Parish, Louisiana",3981,1799,2182,22049,38029,43852,21594,NA,NA,NA,6201,1155,6669,1008,12870,2163,"Jackson Parish, Louisiana(7,9)",80.5,18,"Jackson Parish, Louisiana",70.7,15,stable,15858,22,49,70.7,80.5
LA,"Jefferson Parish, Louisiana",72319,30773,41546,22051,47947,54354,34002,39531,60511,40995,170170,38834,190812,31948,360982,70782,"Jefferson Parish, Louisiana(7,9)",67.4,340,"Jefferson Parish, Louisiana",52.3,262,stable,436275,22,51,52.3,67.4
LA,"Jefferson Davis Parish, Louisiana",6462,2713,3749,22053,39063,44171,20053,20848,NA,16750,13196,1961,13402,2304,26598,4265,"Jefferson Davis Parish, Louisiana(7,9)",81.8,31,"Jefferson Davis Parish, Louisiana",70.1,27,stable,31439,22,53,70.1,81.8
LA,"Lafayette Parish, Louisiana",36346,15225,21121,22055,51869,61544,29224,132588,60802,44336,95586,16284,100459,17188,196045,33472,"Lafayette Parish, Louisiana(7,9)",69.9,145,"Lafayette Parish, Louisiana",52,107,falling,240098,22,55,52,69.9
LA,"Lafourche Parish, Louisiana",14117,5730,8387,22057,51030,54243,28335,NA,70234,40318,40417,6919,42188,7112,82605,14031,"LaFourche Parish, Louisiana(7,9)",70.9,73,"LaFourche Parish, Louisiana",59.9,62,falling,98325,22,57,59.9,70.9
LA,"LaSalle Parish, Louisiana",2857,1184,1673,22059,37310,38953,18000,56601,NA,NA,5609,1111,5849,1087,11458,2198,"La Salle Parish, Louisiana(7,9)",87.6,16,"La Salle Parish, Louisiana",62.3,11,stable,14974,22,59,62.3,87.6
LA,"Lincoln Parish, Louisiana",14146,6360,7786,22061,33467,50425,20715,NA,36250,15995,18702,3888,20323,3822,39025,7710,"Lincoln Parish, Louisiana(7,9)",60.7,27,"Lincoln Parish, Louisiana",45.9,20,falling,47774,22,61,45.9,60.7
LA,"Livingston Parish, Louisiana",19086,7960,11126,22063,58251,58708,41776,124076,NA,62868,54967,10265,58238,9526,113205,19791,"Livingston Parish, Louisiana(7,9)",81.6,98,"Livingston Parish, Louisiana",66.4,77,falling,137788,22,63,66.4,81.6
LA,"Madison Parish, Louisiana",3962,1840,2122,22065,23854,40903,16799,NA,NA,NA,3300,1738,3621,1747,6921,3485,"Madison Parish, Louisiana(7,9)",66.7,9,"Madison Parish, Louisiana",41.3,5,stable,11514,22,65,41.3,66.7
LA,"Morehouse Parish, Louisiana",7432,3212,4220,22067,28003,37849,20261,15938,80595,10733,9869,2442,11441,2459,21310,4901,"Morehouse Parish, Louisiana(7,9)",76.1,27,"Morehouse Parish, Louisiana",52.7,18,stable,26395,22,67,52.7,76.1
LA,"Natchitoches Parish, Louisiana",11208,4921,6287,22069,31345,45440,20172,21250,89167,35893,15049,3127,16951,3484,32000,6611,"Natchitoches Parish, Louisiana(7,9)",66,29,"Natchitoches Parish, Louisiana",52.7,23,stable,39179,22,69,52.7,66
LA,"Orleans Parish, Louisiana",98823,42998,55825,22071,36792,62490,25347,37875,46592,40232,144150,32246,167332,27871,311482,60117,"Orleans Parish, Louisiana(7,9)",67.6,242,"Orleans Parish, Louisiana",53.4,185,falling,389617,22,71,53.4,67.6
LA,"Ouachita Parish, Louisiana",36312,14458,21854,22073,37754,50757,22478,21303,61007,47136,55010,13804,65499,15045,120509,28849,"Ouachita Parish, Louisiana(7,9)",78.3,126,"Ouachita Parish, Louisiana",62,99,falling,156761,22,73,62,78.3
LA,"Plaquemines Parish, Louisiana",3775,1348,2427,22075,50314,56288,34125,NA,NA,33197,9586,1469,10469,1260,20055,2729,"Plaquemines Parish, Louisiana(7,9)",70.4,17,"Plaquemines Parish, Louisiana",51.6,12,stable,23495,22,75,51.6,70.4
LA,"Pointe Coupee Parish, Louisiana",4368,1876,2492,22077,43825,57022,24882,NA,NA,20724,8902,1807,9933,1729,18835,3536,"Pointe Coupee Parish, Louisiana(7,9)",53.5,17,"Pointe Coupee Parish, Louisiana",44.1,13,stable,22251,22,77,44.1,53.5
LA,"Rapides Parish, Louisiana",26645,11724,14921,22079,40734,48821,26263,45208,31526,42311,51678,10140,57797,9853,109475,19993,"Rapides Parish, Louisiana(7,9)",68.9,103,"Rapides Parish, Louisiana",53.7,81,falling,132141,22,79,53.7,68.9
LA,"Red River Parish, Louisiana",1937,803,1134,22081,38000,45547,24770,NA,NA,NA,3476,734,3741,775,7217,1509,"Red River Parish, Louisiana(7,9)",57.9,6,"Red River Parish, Louisiana",39.4,4,stable,8593,22,81,39.4,57.9
LA,"Richland Parish, Louisiana",4154,1825,2329,22083,36421,47766,21617,NA,NA,41125,6428,3106,7524,2868,13952,5974,"Richland Parish, Louisiana(7,9)",79,19,"Richland Parish, Louisiana",57.5,14,stable,20523,22,83,57.5,79
LA,"Sabine Parish, Louisiana",4626,1836,2790,22085,38828,44966,22283,31919,NA,30329,9729,2123,9862,2117,19591,4240,"Sabine Parish, Louisiana(7,9)",66.5,23,"Sabine Parish, Louisiana",59.5,20,stable,24186,22,85,59.5,66.5
LA,"St. Bernard Parish, Louisiana",8209,3529,4680,22087,42753,46517,31497,44205,33313,36853,17811,3166,18950,2585,36761,5751,"St. Bernard Parish, Louisiana(7,9)",97.4,33,"St. Bernard Parish, Louisiana",79.8,26,stable,45408,22,87,79.8,97.4
LA,"St. Charles Parish, Louisiana",6152,2412,3740,22089,59990,70933,35125,NA,71375,59564,21539,3573,23413,3456,44952,7029,"St. Charles Parish, Louisiana(7,9)",71.2,36,"St. Charles Parish, Louisiana",58.8,29,stable,52812,22,89,58.8,71.2
LA,"St. Helena Parish, Louisiana",2854,1309,1545,22091,35437,50649,26136,NA,NA,NA,3913,1245,4593,943,8506,2188,"St. Helena Parish, Louisiana(7,9)",64.3,9,"St. Helena Parish, Louisiana",67.1,9,stable,10567,22,91,67.1,64.3
LA,"St. James Parish, Louisiana",3841,1845,1996,22093,51107,67689,33868,NA,NA,NA,8688,1575,9829,1335,18517,2910,"St. James Parish, Louisiana(7,9)",58,14,"St. James Parish, Louisiana",53.3,13,stable,21567,22,93,53.3,58
LA,"St. John the Baptist Parish, Louisiana",7893,3390,4503,22095,50921,58359,45754,NA,NA,42308,17705,3182,19606,2968,37311,6150,"St. John the Baptist Parish, Louisiana(7,9)",61.6,27,"St. John the Baptist Parish, Louisiana",56.3,25,falling,43626,22,95,56.3,61.6
LA,"St. Landry Parish, Louisiana",22970,9790,13180,22097,32625,44394,19336,NA,NA,47591,33611,6006,36207,6717,69818,12723,"St. Landry Parish, Louisiana(7,9)",80.3,76,"St. Landry Parish, Louisiana",61.2,58,stable,83848,22,97,61.2,80.3
LA,"St. Martin Parish, Louisiana",9388,3920,5468,22099,42794,51701,30231,78750,23438,50147,22517,3509,22724,4110,45241,7619,"St. Martin Parish, Louisiana(7,9)",75.1,42,"St. Martin Parish, Louisiana",61.5,34,falling,53835,22,99,61.5,75.1
LA,"St. Mary Parish, Louisiana",11746,4967,6779,22101,40781,48906,25172,53080,49211,41365,20511,5130,22112,4804,42623,9934,"St. Mary Parish, Louisiana(7,9)",66.6,40,"St. Mary Parish, Louisiana",53.4,33,falling,52810,22,101,53.4,66.6
LA,"St. Tammany Parish, Louisiana",27482,11568,15914,22103,62137,65539,39373,27065,80583,48173,100907,15203,110031,14275,210938,29478,"St. Tammany Parish, Louisiana(7,9)",67.3,179,"St. Tammany Parish, Louisiana",51.5,135,falling,250088,22,103,51.5,67.3
LA,"Tangipahoa Parish, Louisiana",26962,11734,15228,22105,41302,51528,25771,31356,NA,35920,49445,11132,54218,9950,103663,21082,"Tangipahoa Parish, Louisiana(7,9)",79.3,100,"Tangipahoa Parish, Louisiana",62.4,77,falling,128755,22,105,62.4,79.3
LA,"Tensas Parish, Louisiana",1685,731,954,22107,22940,36550,15375,NA,NA,NA,1437,819,1794,707,3231,1526,"Tensas Parish, Louisiana(7,9)",58.5,4,"Tensas Parish, Louisiana",58.6,4,stable,4740,22,107,58.6,58.5
LA,"Terrebonne Parish, Louisiana",21627,9182,12445,22109,47826,55365,28439,38821,46492,55000,45137,9743,47124,9504,92261,19247,"Terrebonne Parish, Louisiana(7,9)",76.2,86,"Terrebonne Parish, Louisiana",57.1,64,falling,113972,22,109,57.1,76.2
LA,"Union Parish, Louisiana",6166,2682,3484,22111,34992,45232,17362,NA,NA,19237,9243,1520,9346,2002,18589,3522,"Union Parish, Louisiana(7,9)",78.9,24,"Union Parish, Louisiana",73.6,22,stable,22477,22,111,73.6,78.9
LA,"Vermilion Parish, Louisiana",10379,4185,6194,22113,45374,49875,22921,52552,39214,41042,23925,4489,26220,4020,50145,8509,"Vermilion Parish, Louisiana(7,9)",77.5,49,"Vermilion Parish, Louisiana",56.5,36,stable,59875,22,113,56.5,77.5
LA,"Vernon Parish, Louisiana",7403,3280,4123,22115,46312,47358,39437,43750,60809,44740,19463,2999,21583,2744,41046,5743,"Vernon Parish, Louisiana(7,9)",91.7,39,"Vernon Parish, Louisiana",72.1,30,stable,50803,22,115,72.1,91.7
LA,"Washington Parish, Louisiana",11811,5364,6447,22117,30705,35372,20771,NA,NA,NA,17546,3722,19486,4016,37032,7738,"Washington Parish, Louisiana(7,9)",92,53,"Washington Parish, Louisiana",67.4,39,stable,46371,22,117,67.4,92
LA,"Webster Parish, Louisiana",9327,4117,5210,22119,33681,43822,19949,38125,68603,26103,15408,3646,17022,3617,32430,7263,"Webster Parish, Louisiana(7,9)",86.3,46,"Webster Parish, Louisiana",55.6,30,stable,40021,22,119,55.6,86.3
LA,"West Baton Rouge Parish, Louisiana",4662,1883,2779,22121,53703,66266,31859,NA,65833,37422,9882,1667,11267,1171,21149,2838,"West Baton Rouge Parish, Louisiana(7,9)",71.5,18,"West Baton Rouge Parish, Louisiana",54.9,13,stable,25490,22,121,54.9,71.5
LA,"West Carroll Parish, Louisiana",2746,1066,1680,22123,31926,37430,19888,NA,NA,30938,3298,1763,3779,1842,7077,3605,"West Carroll Parish, Louisiana(7,9)",78.5,12,"West Carroll Parish, Louisiana",70.8,11,stable,11293,22,123,70.8,78.5
LA,"West Feliciana Parish, Louisiana",1914,1016,898,22125,56685,85140,22232,NA,NA,NA,6066,805,4546,575,10612,1380,"West Feliciana Parish, Louisiana(7,9)",80.1,14,"West Feliciana Parish, Louisiana",56.9,10,stable,15385,22,125,56.9,80.1
LA,"Winn Parish, Louisiana",3466,1506,1960,22127,31087,40856,16917,NA,NA,NA,5058,1136,5731,1183,10789,2319,"Winn Parish, Louisiana(7,9)",80.3,15,"Winn Parish, Louisiana",66.1,12,stable,14568,22,127,66.1,80.3
MA,"Barnstable County, Massachusetts",18392,8191,10201,25001,63251,64278,46864,35125,47115,60436,96016,5058,106883,4331,202899,9389,"Barnstable County, Massachusetts(6,10)",60,247,"Barnstable County, Massachusetts",41.5,175,falling,214333,25,1,41.5,60
MA,"Berkshire County, Massachusetts",16038,6834,9204,25003,49956,50671,29258,21000,65063,45777,58717,2525,64310,1472,123027,3997,"Berkshire County, Massachusetts(6,10)",70,135,"Berkshire County, Massachusetts",47.9,95,falling,127828,25,3,47.9,70
MA,"Bristol County, Massachusetts",68016,29385,38631,25005,56842,59762,42267,28030,77000,28369,251666,12617,273204,8304,524870,20921,"Bristol County, Massachusetts(6,10)",72.9,476,"Bristol County, Massachusetts",49.6,326,falling,556772,25,5,49.6,72.9
MA,"Dukes County, Massachusetts",1970,802,1168,25007,64222,67545,40625,NA,65417,NA,7430,957,8134,416,15564,1373,"Dukes County, Massachusetts(6,10)",53.7,13,"Dukes County, Massachusetts",42.2,10,stable,17299,25,7,42.2,53.7
MA,"Essex County, Massachusetts",85417,35457,49960,25009,69068,74466,46226,40160,85049,37182,346008,17841,381455,11050,727463,28891,"Essex County, Massachusetts(6,10)",67.5,602,"Essex County, Massachusetts",43.3,390,falling,776043,25,9,43.3,67.5
MA,"Franklin County, Massachusetts",8210,3508,4702,25011,55221,55818,36250,NA,44219,32333,32927,1385,35098,984,68025,2369,"Franklin County, Massachusetts(6,10)",52.1,50,"Franklin County, Massachusetts",36.3,35,stable,70601,25,11,36.3,52.1
MA,"Hampden County, Massachusetts",79308,34517,44791,25013,50461,56124,37149,17045,50595,22847,211241,11563,233061,6691,444302,18254,"Hampden County, Massachusetts(6,10)",67.8,368,"Hampden County, Massachusetts",49.5,271,falling,470690,25,13,49.5,67.8
MA,"Hampshire County, Massachusetts",20317,9564,10753,25015,61368,62172,29178,NA,54318,47026,71865,2788,82499,2255,154364,5043,"Hampshire County, Massachusetts(6,10)",52.5,90,"Hampshire County, Massachusetts",39.9,68,falling,161292,25,15,39.9,52.5
MA,"Middlesex County, Massachusetts",124958,53601,71357,25017,85118,87980,47720,59211,97198,49832,718895,30371,771113,20090,1490008,50461,"Middlesex County, Massachusetts(6,10)",61.8,1031,"Middlesex County, Massachusetts",42.5,713,falling,1585139,25,17,42.5,61.8
MA,"Nantucket County, Massachusetts",1205,657,548,25019,84057,88223,54745,NA,NA,88480,5049,506,4666,283,9715,789,"Nantucket County, Massachusetts(6,10)",52.8,6,"Nantucket County, Massachusetts",42.7,5,falling,10925,25,19,42.7,52.8
MA,"Norfolk County, Massachusetts",44199,17778,26421,25021,88262,90667,63775,57500,89513,74641,315500,8590,348517,6448,664017,15038,"Norfolk County, Massachusetts(6,10)",63,511,"Norfolk County, Massachusetts",42.8,354,falling,696023,25,21,42.8,63
MA,"Plymouth County, Massachusetts",40309,17589,22720,25023,75459,80187,43643,91528,82303,54528,230787,9501,249253,6633,480040,16134,"Plymouth County, Massachusetts(6,10)",72.4,430,"Plymouth County, Massachusetts",49.6,292,falling,510393,25,23,49.6,72.4
MA,"Suffolk County, Massachusetts",148278,64005,84273,25025,55044,68686,38856,23804,40287,36030,339121,23427,375290,14000,714411,37427,"Suffolk County, Massachusetts(6,10)",69.7,448,"Suffolk County, Massachusetts",45.6,292,falling,778121,25,25,45.6,69.7
MA,"Worcester County, Massachusetts",92288,40222,52066,25027,65313,67708,43082,37309,81478,32751,375789,16106,397311,9771,773100,25877,"Worcester County, Massachusetts(6,10)",69.8,616,"Worcester County, Massachusetts",50.1,439,falling,818963,25,27,50.1,69.8
MD,"Allegany County, Maryland",11927,5722,6205,24001,40551,41115,19054,2499,NA,28571,30584,2908,32601,2070,63185,4978,"Allegany County, Maryland(6,10)",78.1,82,"Allegany County, Maryland",45.7,48,falling,72528,24,1,45.7,78.1
MD,"Anne Arundel County, Maryland",31573,13598,17975,24003,89860,94882,74802,39755,100983,67667,240091,19346,260900,14834,500991,34180,"Anne Arundel County, Maryland(6,10)",64.3,364,"Anne Arundel County, Maryland",50.1,277,falling,564195,24,3,50.1,64.3
MD,"Baltimore County, Maryland",75464,30881,44583,24005,67095,71270,58471,53173,77066,54937,349705,36042,399264,29786,748969,65828,"Baltimore County, Maryland(6,10)",67.6,661,"Baltimore County, Maryland",47.8,471,falling,831128,24,5,47.8,67.6
MD,"Calvert County, Maryland",5207,2044,3163,24009,95828,101893,63879,NA,103421,91333,40547,3060,42835,2344,83382,5404,"Calvert County, Maryland(6,10)",64.7,57,"Calvert County, Maryland",49.4,43,falling,90595,24,9,49.4,64.7
MD,"Caroline County, Maryland",5086,2254,2832,24011,52465,55892,30530,30476,46667,36500,13480,2162,15141,1486,28621,3648,"Caroline County, Maryland(6,10)",75.1,28,"Caroline County, Maryland",56.7,22,stable,32579,24,11,56.7,75.1
MD,"Carroll County, Maryland",9205,4085,5120,24013,85385,85355,77527,NA,110750,68867,77013,4409,80583,3425,157596,7834,"Carroll County, Maryland(6,10)",61,117,"Carroll County, Maryland",47.9,90,falling,167627,24,13,47.9,61
MD,"Cecil County, Maryland",10179,4664,5515,24015,66396,68674,46724,NA,53409,49919,45549,4270,47305,3698,92854,7968,"Cecil County, Maryland(6,10)",79.2,85,"Cecil County, Maryland",64.4,69,falling,102382,24,15,64.4,79.2
MD,"Charles County, Maryland",11905,4933,6972,24017,90607,94431,84260,67750,116250,95779,67034,4660,75125,3317,142159,7977,"Charles County, Maryland(6,10)",55.4,74,"Charles County, Maryland",47.1,61,falling,156118,24,17,47.1,55.4
MD,"Dorchester County, Maryland",5275,2146,3129,24019,47093,58862,28212,NA,75625,46490,13800,1515,15552,1228,29352,2743,"Dorchester County, Maryland(6,10)",73.1,34,"Dorchester County, Maryland",62,29,falling,32384,24,19,62,73.1
MD,"Frederick County, Maryland",16204,7194,9010,24021,83700,87069,64241,72361,74717,66260,108742,8968,114221,7176,222963,16144,"Frederick County, Maryland(6,10)",52.7,124,"Frederick County, Maryland",40.6,95,falling,245322,24,21,40.6,52.7
MD,"Garrett County, Maryland",3615,1673,1942,24023,45432,45404,NA,111250,65458,70972,12834,1649,13368,1480,26202,3129,"Garrett County, Maryland(6,10)",49.5,21,"Garrett County, Maryland",46.3,19,stable,29460,24,23,46.3,49.5
MD,"Harford County, Maryland",19854,8342,11512,24025,80465,82674,61374,NA,82201,72233,113060,7086,120857,5276,233917,12362,"Harford County, Maryland(6,10)",68.6,184,"Harford County, Maryland",49.9,131,falling,250290,24,25,49.9,68.6
MD,"Howard County, Maryland",15759,6684,9075,24027,110238,120146,86509,76435,114874,76619,137570,9750,145908,8370,283478,18120,"Howard County, Maryland(6,10)",44.4,118,"Howard County, Maryland",28.8,74,falling,313414,24,27,28.8,44.4
MD,"Kent County, Maryland",2051,825,1226,24029,58147,61438,25233,NA,53550,57889,8298,942,9733,599,18031,1541,"Kent County, Maryland(6,10)",61.1,20,"Kent County, Maryland",53.4,18,stable,19787,24,29,53.4,61.1
MD,"Montgomery County, Maryland",67820,28612,39208,24031,99435,114879,68759,63463,103872,67759,430903,54617,474753,48905,905656,103522,"Montgomery County, Maryland(6,10)",35.4,371,"Montgomery County, Maryland",25,263,falling,1040116,24,31,25,35.4
MD,"Prince George's County, Maryland",84018,36085,47933,24033,74260,77972,75021,59566,78504,60333,355547,69865,408095,52586,763642,122451,"Prince Georges County, Maryland(6,10)",46.6,361,"Prince Georges County, Maryland",40,299,falling,909535,24,33,40,46.6
MD,"Queen Anne's County, Maryland",3588,1721,1867,24035,85963,89912,42852,NA,NA,82625,22094,1470,23452,999,45546,2469,"Queen Annes County, Maryland(6,10)",63.9,39,"Queen Annes County, Maryland",47.1,27,falling,48904,24,35,47.1,63.9
MD,"St. Mary's County, Maryland",8384,3098,5286,24037,86987,92783,47808,99167,98570,66250,48738,3615,51331,3219,100069,6834,"St. Marys County, Maryland(6,10)",68.8,68,"St. Marys County, Maryland",54,52,falling,111413,24,37,54,68.8
MD,"Somerset County, Maryland",4681,1834,2847,24039,35154,40613,29381,NA,37250,26594,8510,1033,10465,1225,18975,2258,"Somerset County, Maryland(6,10)",95.9,29,"Somerset County, Maryland",70.4,21,falling,25768,24,39,70.4,95.9
MD,"Talbot County, Maryland",4202,1493,2709,24041,58228,65670,31063,NA,53953,36165,15681,1921,18088,1719,33769,3640,"Talbot County, Maryland(6,10)",51.1,34,"Talbot County, Maryland",40,28,stable,37512,24,41,40,51.1
MD,"Washington County, Maryland",18094,7436,10658,24043,56228,57810,37613,35625,70278,46176,62393,6419,66780,5372,129173,11791,"Washington County, Maryland(6,10)",71.8,126,"Washington County, Maryland",53.5,94,falling,149585,24,43,53.5,71.8
MD,"Wicomico County, Maryland",15493,6604,8889,24045,52278,56508,39019,50729,57131,39439,41662,5754,48196,4245,89858,9999,"Wicomico County, Maryland(6,10)",79.4,87,"Wicomico County, Maryland",59.7,65,stable,102370,24,45,59.7,79.4
MD,"Worcester County, Maryland",5567,2436,3131,24047,56773,60281,31871,79135,58500,53902,21853,2792,24194,2068,46047,4860,"Worcester County, Maryland(6,10)",70.2,63,"Worcester County, Maryland",59.8,54,stable,51540,24,47,59.8,70.2
MD,"Baltimore city, Maryland",141654,62133,79521,24510,42241,63126,33702,22757,51064,44509,249644,36380,299583,27012,549227,63392,"Baltimore City, Maryland(6,10)",80.9,512,"Baltimore City, Maryland",61.8,388,falling,621849,24,510,61.8,80.9
ME,"Androscoggin County, Maine",16332,7347,8985,23001,47537,48401,20481,NA,73295,33000,46709,5390,50154,4136,96863,9526,"Androscoggin County, Maine(6,10)",78.1,101,"Androscoggin County, Maine",60.8,80,stable,107233,23,1,60.8,78.1
ME,"Aroostook County, Maine",12608,5761,6847,23003,36923,37289,24500,18009,86667,30167,29842,4255,31765,3092,61607,7347,"Aroostook County, Maine(6,10)",84.1,92,"Aroostook County, Maine",62.2,68,stable,68628,23,3,62.2,84.1
ME,"Cumberland County, Maine",32339,15055,17284,23005,60051,61525,20200,32167,50693,41569,123850,13135,135529,10366,259379,23501,"Cumberland County, Maine(6,10)",68.3,237,"Cumberland County, Maine",48.9,169,falling,289977,23,5,48.9,68.3
ME,"Franklin County, Maine",4318,1971,2347,23007,42811,42892,NA,40673,NA,142344,13230,1633,13653,1736,26883,3369,"Franklin County, Maine(6,10)",57.7,24,"Franklin County, Maine",48.3,20,falling,29991,23,7,48.3,57.7
ME,"Hancock County, Maine",7196,3075,4121,23009,47030,47369,31734,40464,63194,45833,22315,4190,24230,3497,46545,7687,"Hancock County, Maine(6,10)",68.8,56,"Hancock County, Maine",47.1,39,falling,54659,23,9,47.1,68.8
ME,"Kennebec County, Maine",16256,7316,8940,23011,46917,47161,NA,41487,42181,36250,51871,6022,57298,4550,109169,10572,"Kennebec County, Maine(6,10)",75.6,121,"Kennebec County, Maine",57.3,91,falling,119980,23,11,57.3,75.6
ME,"Knox County, Maine",4304,2232,2072,23013,50693,50912,NA,68611,34732,35486,15898,2827,17774,2158,33672,4985,"Knox County, Maine(6,10)",72,45,"Knox County, Maine",49.2,31,stable,39855,23,13,49.2,72
ME,"Lincoln County, Maine",4073,1809,2264,23015,50462,50394,NA,NA,85313,57414,14128,2238,15508,1775,29636,4013,"Lincoln County, Maine(6,10)",50.8,30,"Lincoln County, Maine",43.8,26,falling,33969,23,15,43.8,50.8
ME,"Oxford County, Maine",9911,4357,5554,23017,40630,40630,NA,NA,31548,NA,24711,3543,25809,2981,50520,6524,"Oxford County, Maine(6,10)",85.6,70,"Oxford County, Maine",60.9,50,stable,57202,23,17,60.9,85.6
ME,"Penobscot County, Maine",24933,11157,13776,23019,44271,44456,30938,23646,74091,51875,65459,9179,69243,7781,134702,16960,"Penobscot County, Maine(6,10)",84.4,160,"Penobscot County, Maine",60.4,116,stable,152692,23,19,60.4,84.4
ME,"Piscataquis County, Maine",3520,1643,1877,23021,37495,37763,NA,90417,NA,35875,7265,1242,7529,985,14794,2227,"Piscataquis County, Maine(6,10)",75.8,21,"Piscataquis County, Maine",56.3,15,stable,16931,23,21,56.3,75.8
ME,"Sagadahoc County, Maine",4200,1710,2490,23023,53298,53997,NA,NA,NA,25781,15131,1641,16850,1267,31981,2908,"Sagadahoc County, Maine(6,10)",66,31,"Sagadahoc County, Maine",49.3,23,falling,35149,23,23,49.3,66
ME,"Somerset County, Maine",8907,4162,4745,23025,40066,39949,NA,23750,NA,37670,21672,3489,23389,2515,45061,6004,"Somerset County, Maine(6,10)",84.3,60,"Somerset County, Maine",57.9,41,falling,51113,23,25,57.9,84.3
ME,"Waldo County, Maine",6243,2895,3348,23027,44082,44448,NA,19583,45000,26750,16656,2339,17567,2185,34223,4524,"Waldo County, Maine(6,10)",83.6,44,"Waldo County, Maine",56.5,29,falling,39155,23,27,56.5,83.6
ME,"Washington County, Maine",5946,2598,3348,23029,38083,38816,72875,26413,NA,50862,13241,2331,14250,1811,27491,4142,"Washington County, Maine(6,10)",87.8,45,"Washington County, Maine",61.1,31,stable,31625,23,29,61.1,87.8
ME,"York County, Maine",19192,7672,11520,23031,57919,58141,54063,27150,47110,50390,85969,10381,94299,7360,180268,17741,"York County, Maine(6,10)",71.7,187,"York County, Maine",48.3,127,falling,201169,23,31,48.3,71.7
MI,"Alcona County, Michigan",1575,709,866,26001,38033,38313,NA,59219,NA,NA,4712,568,4643,531,9355,1099,"Alcona County, Michigan(6,10)",66.2 #,15,"Alcona County, Michigan",68.2,17,stable,10349,26,1,68.2,NA
MI,"Alger County, Michigan",1213,635,578,26003,39300,38853,NA,36042,NA,NA,3733,590,3747,429,7480,1019,"Alger County, Michigan(6,10)",48.6 #,8,"Alger County, Michigan",48.4,8,falling,9383,26,3,48.4,NA
MI,"Allegan County, Michigan",14185,6447,7738,26005,54264,54439,42047,49750,64063,41733,50610,5289,51742,4477,102352,9766,"Allegan County, Michigan(6,10)",53.7 #,70,"Allegan County, Michigan",46.6,59,stable,114625,26,5,46.6,NA
MI,"Alpena County, Michigan",4898,2193,2705,26007,38829,38966,29375,26944,NA,NA,12241,1820,13037,1605,25278,3425,"Alpena County, Michigan(6,10)",77.1 #,35,"Alpena County, Michigan",54.3,25,stable,28803,26,7,54.3,NA
MI,"Antrim County, Michigan",3316,1451,1865,26009,46845,47290,NA,62750,36042,40294,10140,1370,10359,1232,20499,2602,"Antrim County, Michigan(6,10)",59.1 #,24,"Antrim County, Michigan",47,19,falling,23154,26,9,47,NA
MI,"Arenac County, Michigan",3013,1512,1501,26011,38307,38308,NA,NA,NA,45000,6758,977,6890,630,13648,1607,"Arenac County, Michigan(6,10)",104.9 #,27,"Arenac County, Michigan",83.8,21,stable,15261,26,11,83.8,NA
MI,"Baraga County, Michigan",992,423,569,26013,39803,40481,NA,30125,34167,NA,2832,242,3020,293,5852,535,"Baraga County, Michigan(6,10)",74.9 #,9,"Baraga County, Michigan",58.8,7,stable,8575,26,13,58.8,NA
MI,"Barry County, Michigan",6377,2907,3470,26015,55064,55248,NA,27500,165982,40746,26953,2512,27124,2071,54077,4583,"Barry County, Michigan(6,10)",45.3 #,34,"Barry County, Michigan",43.8,33,stable,59314,26,15,43.8,NA
MI,"Bay County, Michigan",15804,7485,8319,26017,45583,46205,28316,48409,99444,33507,46672,5401,49948,3721,96620,9122,"Bay County, Michigan(6,10)",60.7 #,87,"Bay County, Michigan",51.3,74,stable,105659,26,17,51.3,NA
MI,"Benzie County, Michigan",1989,936,1053,26019,47388,47885,NA,31000,NA,25350,7415,1202,7759,873,15174,2075,"Benzie County, Michigan(6,10)",71.4 #,21,"Benzie County, Michigan",63.8,18,stable,17457,26,19,63.8,NA
MI,"Berrien County, Michigan",26719,11545,15174,26021,44993,50681,20854,52344,65313,36541,66019,9480,70814,8026,136833,17506,"Berrien County, Michigan(6,10)",69.7 #,143,"Berrien County, Michigan",53.2,109,falling,154636,26,21,53.2,NA
MI,"Branch County, Michigan",7310,3527,3783,26023,44373,44359,NA,NA,55208,24904,17948,2654,18762,2211,36710,4865,"Branch County, Michigan(6,10)",61.6 #,34,"Branch County, Michigan",48.6,27,stable,43664,26,23,48.6,NA
MI,"Calhoun County, Michigan",22931,10265,12666,26025,42520,45354,25172,47266,46690,35309,57482,7460,62320,5876,119802,13336,"Calhoun County, Michigan(6,10)",71.1 #,119,"Calhoun County, Michigan",58.9,99,stable,134314,26,25,58.9,NA
MI,"Cass County, Michigan",7576,3689,3887,26027,46570,48467,31850,48221,NA,31605,22876,3208,23121,2612,45997,5820,"Cass County, Michigan(6,10)",56.1 #,39,"Cass County, Michigan",52.8,36,falling,51657,26,27,52.8,NA
MI,"Charlevoix County, Michigan",3181,1431,1750,26029,46554,46730,NA,40938,67917,45000,11309,1423,12008,1126,23317,2549,"Charlevoix County, Michigan(6,10)",61.7 #,24,"Charlevoix County, Michigan",45.1,18,falling,26238,26,29,45.1,NA
MI,"Cheboygan County, Michigan",4595,2023,2572,26031,40219,40860,65000,34583,NA,25909,10755,1840,11273,1519,22028,3359,"Cheboygan County, Michigan(6,10)",73.6 #,32,"Cheboygan County, Michigan",62.7,27,stable,25427,26,31,62.7,NA
MI,"Chippewa County, Michigan",6485,3312,3173,26033,41993,43546,NA,39107,30982,49375,15235,2328,15554,1781,30789,4109,"Chippewa County, Michigan(6,10)",73.6 #,34,"Chippewa County, Michigan",59.3,27,stable,38033,26,33,59.3,NA
MI,"Clare County, Michigan",7895,3545,4350,26035,33015,33138,NA,NA,89107,25750,12679,2275,13375,2058,26054,4333,"Clare County, Michigan(6,10)",75.6 #,37,"Clare County, Michigan",64.6,31,falling,30553,26,35,64.6,NA
MI,"Clinton County, Michigan",8933,4098,4835,26037,60909,61597,33585,NA,50521,43295,34356,3186,36596,2139,70952,5325,"Clinton County, Michigan(6,10)",36.6 #,31,"Clinton County, Michigan",38.9,33,falling,77390,26,37,38.9,NA
MI,"Crawford County, Michigan",2073,977,1096,26039,41743,42022,NA,NA,10750,NA,6315,630,6190,578,12505,1208,"Crawford County, Michigan(6,10)",73 #,17,"Crawford County, Michigan",67.1,16,stable,13801,26,39,67.1,NA
MI,"Delta County, Michigan",6227,2966,3261,26041,42031,42837,NA,27411,21078,19375,15893,2084,16433,1892,32326,3976,"Delta County, Michigan(6,10)",63.2 #,36,"Delta County, Michigan",47.7,27,falling,36377,26,41,47.7,NA
MI,"Dickinson County, Michigan",3523,1489,2034,26043,43779,44013,NA,NA,NA,75833,11386,1309,12033,912,23419,2221,"Dickinson County, Michigan(6,10)",50.7 #,20,"Dickinson County, Michigan",46.5,19,stable,25788,26,43,46.5,NA
MI,"Eaton County, Michigan",11524,5064,6460,26045,54993,56680,37141,59250,62375,50667,47705,4843,51387,3728,99092,8571,"Eaton County, Michigan(6,10)",51.8 #,68,"Eaton County, Michigan",48.3,62,stable,108801,26,45,48.3,NA
MI,"Emmet County, Michigan",3506,1504,2002,26047,51018,51499,NA,39395,79375,30721,14287,1872,15012,1507,29299,3379,"Emmet County, Michigan(6,10)",63 #,29,"Emmet County, Michigan",53.8,25,stable,33161,26,47,53.8,NA
MI,"Genesee County, Michigan",85696,38849,46847,26049,42327,47601,25521,38615,89286,42454,178891,20287,199440,14671,378331,34958,"Genesee County, Michigan(6,10)",80.3 #,399,"Genesee County, Michigan",60.6,298,stable,410849,26,49,60.6,NA
MI,"Gladwin County, Michigan",5211,2382,2829,26051,38021,38022,NA,18917,NA,43523,10845,1845,11109,1476,21954,3321,"Gladwin County, Michigan(6,10)",79 #,35,"Gladwin County, Michigan",62.8,28,stable,25164,26,51,62.8,NA
MI,"Gogebic County, Michigan",2859,1339,1520,26053,35686,35766,NA,31250,NA,NA,6260,943,6147,942,12407,1885,"Gogebic County, Michigan(6,10)",63.1 #,17,"Gogebic County, Michigan",57,16,stable,15431,26,53,57,NA
MI,"Grand Traverse County, Michigan",9575,4520,5055,26055,52950,53391,NA,49423,37500,51250,37680,4728,41452,3904,79132,8632,"Grand Traverse County, Michigan(6,10)",66.4 #,74,"Grand Traverse County, Michigan",40.8,45,falling,91636,26,55,40.8,NA
MI,"Gratiot County, Michigan",6792,2868,3924,26057,41912,42343,NA,15500,NA,30365,16372,1837,17609,1700,33981,3537,"Gratiot County, Michigan(6,10)",66 #,33,"Gratiot County, Michigan",54.1,27,stable,41540,26,57,54.1,NA
MI,"Hillsdale County, Michigan",8982,4302,4680,26059,41961,42168,NA,35625,42917,44000,19711,3065,20196,2809,39907,5874,"Hillsdale County, Michigan(6,10)",62.4 #,39,"Hillsdale County, Michigan",59.1,36,stable,45941,26,59,59.1,NA
MI,"Houghton County, Michigan",7406,4283,3123,26061,37776,39009,NA,30625,18139,36131,17670,2056,15133,1373,32803,3429,"Houghton County, Michigan(6,10)",49.6 #,21,"Houghton County, Michigan",43.9,19,stable,36380,26,61,43.9,NA
MI,"Huron County, Michigan",4486,2093,2393,26063,42161,42172,NA,14028,96389,31818,14149,1771,14664,1337,28813,3108,"Huron County, Michigan(6,10)",56.8 #,31,"Huron County, Michigan",45.4,25,stable,31883,26,63,45.4,NA
MI,"Ingham County, Michigan",59468,27305,32163,26065,45679,49595,31482,41042,42423,35847,123123,13582,135036,10043,258159,23625,"Ingham County, Michigan(6,10)",58.8 #,155,"Ingham County, Michigan",41.6,109,falling,286085,26,65,41.6,NA
MI,"Ionia County, Michigan",9084,4395,4689,26067,49124,49259,83275,73472,NA,39000,27175,3133,27785,2216,54960,5349,"Ionia County, Michigan(6,10)",63.5 #,43,"Ionia County, Michigan",51.1,33,stable,64223,26,67,51.1,NA
MI,"Iosco County, Michigan",4395,2005,2390,26069,37317,37486,NA,NA,NA,42969,10898,1614,11358,1209,22256,2823,"Iosco County, Michigan(6,10)",65.6 #,34,"Iosco County, Michigan",54.9,28,falling,25345,26,69,54.9,NA
MI,"Iron County, Michigan",1749,875,874,26071,33663,33797,NA,30417,46875,32813,4921,649,5149,506,10070,1155,"Iron County, Michigan(6,10)",60.4 #,15,"Iron County, Michigan",50,12,stable,11348,26,71,50,NA
MI,"Isabella County, Michigan",19390,9228,10162,26073,39377,39794,24653,56520,21724,33875,29705,4265,32384,3727,62089,7992,"Isabella County, Michigan(6,10)",69.2 #,41,"Isabella County, Michigan",57.8,33,stable,70698,26,73,57.8,NA
MI,"Jackson County, Michigan",25464,11251,14213,26075,46326,48717,20446,40500,86786,44665,66927,7612,70651,6782,137578,14394,"Jackson County, Michigan(6,10)",82 #,157,"Jackson County, Michigan",61.9,119,stable,159494,26,75,61.9,NA
MI,"Kalamazoo County, Michigan",45473,20808,24665,26077,47476,51598,25584,NA,42484,38564,111892,12752,120882,9318,232774,22070,"Kalamazoo County, Michigan(6,10)",61.3 #,163,"Kalamazoo County, Michigan",47.5,126,stable,260263,26,77,47.5,NA
MI,"Kalkaska County, Michigan",2875,1379,1496,26079,40534,40853,NA,25833,NA,NA,7510,1215,7382,1061,14892,2276,"Kalkaska County, Michigan(6,10)",73.4 #,18,"Kalkaska County, Michigan",72.7,17,stable,17260,26,79,72.7,NA
MI,"Kent County, Michigan",93489,42845,50644,26081,53063,56981,26620,33553,59680,36094,270413,33224,289867,25135,560280,58359,"Kent County, Michigan(6,10)",59.3 #,353,"Kent County, Michigan",41.3,247,falling,636369,26,81,41.3,NA
MI,"Keweenaw County, Michigan",336,169,167,26083,37813,38320,NA,NA,NA,NA,1022,115,956,97,1978,212,"Keweenaw County, Michigan(6,10)",*,3 or fewer,"Keweenaw County, Michigan",*,*,**,2168,26,83,NA,NA
MI,"Lake County, Michigan",3164,1509,1655,26085,30439,32391,13616,NA,NA,NA,4793,755,4941,570,9734,1325,"Lake County, Michigan(6,10)",77.4 #,16,"Lake County, Michigan",66.8,14,stable,11424,26,85,66.8,NA
MI,"Lapeer County, Michigan",9152,4261,4891,26087,52996,53023,8947,NA,NA,38975,38764,4435,39708,3818,78472,8253,"Lapeer County, Michigan(6,10)",71.9 #,76,"Lapeer County, Michigan",56.6,58,stable,88373,26,87,56.6,NA
MI,"Leelanau County, Michigan",2245,1099,1146,26089,56189,57190,NA,28583,NA,44412,9505,1155,10196,775,19701,1930,"Leelanau County, Michigan(6,10)",35.7 #,14,"Leelanau County, Michigan",31.5,13,falling,21981,26,89,31.5,NA
MI,"Lenawee County, Michigan",13427,6044,7383,26091,48043,48743,32452,NA,38750,31194,42704,4735,44449,3837,87153,8572,"Lenawee County, Michigan(6,10)",60 #,73,"Lenawee County, Michigan",48.8,60,stable,98573,26,91,48.8,NA
MI,"Livingston County, Michigan",10895,4813,6082,26093,75204,75159,59350,72885,100139,79917,85073,6726,86466,5495,171539,12221,"Livingston County, Michigan(6,10)",54.6 #,108,"Livingston County, Michigan",44.2,86,falling,187316,26,93,44.2,NA
MI,"Luce County, Michigan",1059,453,606,26095,37088,38668,NA,35089,NA,27857,2435,347,2435,217,4870,564,"Luce County, Michigan(6,10)",84 #,8,"Luce County, Michigan",56.7,6,stable,6415,26,95,56.7,NA
MI,"Mackinac County, Michigan",1730,818,912,26097,38434,40656,NA,31429,33214,44286,4638,839,4680,745,9318,1584,"Mackinac County, Michigan(6,10)",61.9 #,12,"Mackinac County, Michigan",46.6,9,stable,10890,26,97,46.6,NA
MI,"Macomb County, Michigan",106546,46437,60109,26099,54582,56997,34265,38107,66980,48125,368100,43732,401222,35114,769322,78846,"Macomb County, Michigan(7,8)",75.2,756,"Macomb County, Michigan",52.2,527,falling,864840,26,99,52.2,75.2
MI,"Manistee County, Michigan",3918,1767,2151,26101,41395,41518,NA,38548,41477,42917,9995,1585,10661,1055,20656,2640,"Manistee County, Michigan(6,10)",67.3 #,27,"Manistee County, Michigan",51.4,21,stable,24461,26,101,51.4,NA
MI,"Marquette County, Michigan",10689,4951,5738,26103,45409,45724,NA,22188,54509,15750,28379,4020,30126,2915,58505,6935,"Marquette County, Michigan(6,10)",64.9 #,54,"Marquette County, Michigan",50.5,42,falling,67215,26,103,50.5,NA
MI,"Mason County, Michigan",4861,2242,2619,26105,42024,42543,31625,30833,NA,31650,12285,1895,12820,1407,25105,3302,"Mason County, Michigan(6,10)",54.9 #,24,"Mason County, Michigan",56.9,25,stable,28783,26,105,56.9,NA
MI,"Mecosta County, Michigan",9338,4257,5081,26107,41889,42455,NA,53917,NA,23162,18956,2724,19265,2128,38221,4852,"Mecosta County, Michigan(6,10)",69.4 #,36,"Mecosta County, Michigan",52.3,27,falling,43067,26,107,52.3,NA
MI,"Menominee County, Michigan",3774,1517,2257,26109,40373,40683,NA,28854,88571,NA,10669,1146,10471,1131,21140,2277,"Menominee County, Michigan(6,10)",50.1 #,19,"Menominee County, Michigan",49.3,19,stable,23548,26,109,49.3,NA
MI,"Midland County, Michigan",10955,4988,5967,26111,54059,53806,35774,40640,104031,44655,37251,3602,39026,3132,76277,6734,"Midland County, Michigan(6,10)",58 #,60,"Midland County, Michigan",40.3,42,falling,83632,26,111,40.3,NA
MI,"Missaukee County, Michigan",2490,1153,1337,26113,41098,41140,47083,35833,76827,48542,6595,1016,6522,738,13117,1754,"Missaukee County, Michigan(6,10)",73.3 #,15,"Missaukee County, Michigan",54.3,11,stable,14903,26,113,54.3,NA
MI,"Monroe County, Michigan",16860,7388,9472,26115,55653,56047,38200,34792,75833,41131,67649,6066,70833,5009,138482,11075,"Monroe County, Michigan(6,10)",63.6 #,115,"Monroe County, Michigan",57,101,stable,149568,26,115,57,NA
MI,"Montcalm County, Michigan",10924,4760,6164,26117,41584,41740,29750,11786,115756,30250,26455,3758,27230,3094,53685,6852,"Montcalm County, Michigan(6,10)",75.3 #,56,"Montcalm County, Michigan",59.2,44,stable,62945,26,117,59.2,NA
MI,"Montmorency County, Michigan",1568,611,957,26119,36250,36132,NA,NA,NA,38750,4024,700,4066,499,8090,1199,"Montmorency County, Michigan(6,10)",78.6 #,15,"Montmorency County, Michigan",56.1,11,stable,9259,26,119,56.1,NA
MI,"Muskegon County, Michigan",31550,14092,17458,26121,42829,46702,21751,44643,NA,33954,72693,8208,79276,6412,151969,14620,"Muskegon County, Michigan(6,10)",77.6 #,155,"Muskegon County, Michigan",58.4,118,stable,172790,26,121,58.4,NA
MI,"Newaygo County, Michigan",8605,3978,4627,26123,43693,44129,31705,50329,31250,34009,21189,2645,21487,2188,42676,4833,"Newaygo County, Michigan(6,10)",63.8 #,40,"Newaygo County, Michigan",60.7,38,stable,47948,26,123,60.7,NA
MI,"Oakland County, Michigan",123086,54727,68359,26125,67465,70729,46821,42222,101426,49646,540991,53142,583675,45780,1124666,98922,"Oakland County, Michigan(7,8)",62.8,866,"Oakland County, Michigan",41,567,falling,1242304,26,125,41,62.8
MI,"Oceana County, Michigan",5285,2524,2761,26127,41617,41925,NA,40938,NA,32094,11339,1861,11398,1458,22737,3319,"Oceana County, Michigan(6,10)",51.2 #,19,"Oceana County, Michigan",46.3,17,falling,26105,26,127,46.3,NA
MI,"Ogemaw County, Michigan",4537,2019,2518,26129,36063,35885,36250,57639,160729,38077,9179,1263,9466,1044,18645,2307,"Ogemaw County, Michigan(6,10)",73.2 #,27,"Ogemaw County, Michigan",58.9,22,stable,20937,26,129,58.9,NA
MI,"Ontonagon County, Michigan",967,464,503,26131,34459,34587,NA,25000,NA,51875,2755,457,2664,358,5419,815,"Ontonagon County, Michigan(6,10)",71.1 #,10,"Ontonagon County, Michigan",55.4,8,stable,6007,26,131,55.4,NA
MI,"Osceola County, Michigan",5032,2248,2784,26133,38999,39103,21406,33125,NA,30833,9666,1847,10119,1340,19785,3187,"Osceola County, Michigan(6,10)",97 #,31,"Osceola County, Michigan",64.2,21,stable,23058,26,133,64.2,NA
MI,"Oscoda County, Michigan",1656,770,886,26135,33021,33417,NA,14375,NA,37143,3544,791,3402,664,6946,1455,"Oscoda County, Michigan(6,10)",87.3 #,14,"Oscoda County, Michigan",66,10,stable,8251,26,135,66,NA
MI,"Otsego County, Michigan",3270,1318,1952,26137,48917,49180,NA,NA,NA,51133,10454,1369,11063,1070,21517,2439,"Otsego County, Michigan(6,10)",68.2 #,23,"Otsego County, Michigan",61.2,21,stable,24253,26,137,61.2,NA
MI,"Ottawa County, Michigan",27361,12381,14980,26139,58989,60547,27889,33942,54567,45592,124049,9990,129902,7876,253951,17866,"Ottawa County, Michigan(6,10)",39.3 #,105,"Ottawa County, Michigan",32.1,86,stable,279955,26,139,32.1,NA
MI,"Presque Isle County, Michigan",1761,792,969,26141,41213,41351,NA,NA,90833,36563,5692,745,5811,629,11503,1374,"Presque Isle County, Michigan(6,10)",57.9 #,15,"Presque Isle County, Michigan",60.2,16,stable,12841,26,141,60.2,NA
MI,"Roscommon County, Michigan",4885,2222,2663,26143,35133,35201,NA,38042,NA,26771,10354,1533,10736,1218,21090,2751,"Roscommon County, Michigan(6,10)",81 #,41,"Roscommon County, Michigan",60.1,30,stable,23898,26,143,60.1,NA
MI,"Saginaw County, Michigan",34825,15792,19033,26145,43042,48007,24158,46719,63417,36160,83873,8958,92158,8175,176031,17133,"Saginaw County, Michigan(6,10)",69.1 #,173,"Saginaw County, Michigan",50.5,127,falling,193307,26,145,50.5,NA
MI,"St. Clair County, Michigan",23128,10571,12557,26147,49730,50565,22699,50625,54013,46766,70567,8439,73895,6338,144462,14777,"St. Clair County, Michigan(6,10)",69.5 #,141,"St. Clair County, Michigan",59.5,122,stable,159875,26,147,59.5,NA
MI,"St. Joseph County, Michigan",10319,4684,5635,26149,44449,45116,24271,38929,NA,31086,26216,3753,27574,2924,53790,6677,"St. Joseph County, Michigan(6,10)",65.7 #,49,"St. Joseph County, Michigan",53,40,stable,61018,26,149,53,NA
MI,"Sanilac County, Michigan",6522,2816,3706,26151,41100,41219,76250,20227,NA,40125,17714,2968,18524,2512,36238,5480,"Sanilac County, Michigan(6,10)",50.2 #,30,"Sanilac County, Michigan",47.6,29,falling,41475,26,151,47.6,NA
MI,"Schoolcraft County, Michigan",1735,831,904,26153,34118,34833,NA,31125,29306,NA,3498,543,3717,421,7215,964,"Schoolcraft County, Michigan(6,10)",70.8 #,10,"Schoolcraft County, Michigan",62,9,stable,8173,26,153,62,NA
MI,"Shiawassee County, Michigan",9790,4325,5465,26155,48233,48337,NA,27750,NA,36667,29932,3966,31666,3101,61598,7067,"Shiawassee County, Michigan(6,10)",77.9 #,67,"Shiawassee County, Michigan",59,51,stable,68619,26,155,59,NA
MI,"Tuscola County, Michigan",8317,3963,4354,26157,43768,43816,24688,50000,90556,38750,23607,3046,24523,2326,48130,5372,"Tuscola County, Michigan(6,10)",73.5 #,55,"Tuscola County, Michigan",52.8,39,stable,53777,26,157,52.8,NA
MI,"Van Buren County, Michigan",14029,6400,7629,26159,46008,48232,19101,29375,NA,36218,32007,5068,34044,3772,66051,8840,"Van Buren County, Michigan(6,10)",68.2 #,63,"Van Buren County, Michigan",58.9,53,stable,75077,26,159,58.9,NA
MI,"Washtenaw County, Michigan",51965,25329,26636,26161,61003,66530,35301,58083,61688,43274,160510,11975,167436,9812,327946,21787,"Washtenaw County, Michigan(6,10)",54.4 #,172,"Washtenaw County, Michigan",39.3,123,falling,358880,26,161,39.3,NA
MI,"Wayne County, Michigan",440449,200486,239963,26163,41210,54162,26888,32859,74541,37103,726438,121939,823153,95246,1549591,217185,"Wayne County, Michigan(7,8)",83,1634,"Wayne County, Michigan",57.7,"1,136",falling,1759335,26,163,57.7,83
MI,"Wexford County, Michigan",5631,2846,2785,26165,41534,41456,16050,46250,100625,NA,14036,2235,14703,1532,28739,3767,"Wexford County, Michigan(6,10)",90.7 #,38,"Wexford County, Michigan",66.9,28,stable,33003,26,165,66.9,NA
MN,"Aitkin County, Minnesota",1937,960,977,27001,42252,42640,NA,32500,67188,55446,7304,628,7277,437,14581,1065,"Aitkin County, Minnesota(6)",_,_,"Aitkin County, Minnesota",40.3,13,falling,15702,27,1,40.3,NA
MN,"Anoka County, Minnesota",25925,12012,13913,27003,70873,73086,43586,51309,71750,45635,155823,11886,159251,9448,315074,21334,"Anoka County, Minnesota(6)",_,_,"Anoka County, Minnesota",48.4,145,stable,344151,27,3,48.4,NA
MN,"Becker County, Minnesota",4160,1754,2406,27005,52038,53711,NA,30650,42500,42679,14446,1952,14841,1504,29287,3456,"Becker County, Minnesota(6)",_,_,"Becker County, Minnesota",46.1,21,stable,33386,27,5,46.1,NA
MN,"Beltrami County, Minnesota",8118,3825,4293,27007,44757,48882,NA,30591,82546,17813,19419,3079,19771,2658,39190,5737,"Beltrami County, Minnesota(6)",_,_,"Beltrami County, Minnesota",41.3,20,stable,45672,27,7,41.3,NA
MN,"Benton County, Minnesota",5732,2314,3418,27009,52178,53595,NA,21645,NA,53000,17465,1820,18070,1356,35535,3176,"Benton County, Minnesota(6)",_,_,"Benton County, Minnesota",38.8,15,stable,39710,27,9,38.8,NA
MN,"Big Stone County, Minnesota",719,260,459,27011,47794,48235,NA,NA,NA,40625,2288,174,2417,126,4705,300,"Big Stone County, Minnesota(6)",_,_,"Big Stone County, Minnesota",55.9,6,stable,5040,27,11,55.9,NA
MN,"Blue Earth County, Minnesota",11745,5827,5918,27013,50061,51956,25134,NA,39279,42656,30414,2115,30581,1479,60995,3594,"Blue Earth County, Minnesota(6)",_,_,"Blue Earth County, Minnesota",39.6,25,stable,65787,27,13,39.6,NA
MN,"Brown County, Minnesota",1887,931,956,27015,52598,53084,NA,42813,NA,32404,11642,841,11987,579,23629,1420,"Brown County, Minnesota(6)",_,_,"Brown County, Minnesota",41.6,16,stable,25313,27,15,41.6,NA
MN,"Carlton County, Minnesota",4727,2502,2225,27017,53227,54957,NA,34417,21402,46833,16346,1305,15943,971,32289,2276,"Carlton County, Minnesota(6)",_,_,"Carlton County, Minnesota",48.7,22,stable,35569,27,17,48.7,NA
MN,"Carver County, Minnesota",4172,1886,2286,27019,86323,86668,50938,62868,117361,70083,44942,2338,46391,1785,91333,4123,"Carver County, Minnesota(6)",_,_,"Carver County, Minnesota",38.8,28,stable,98741,27,19,38.8,NA
MN,"Cass County, Minnesota",4656,2195,2461,27021,46531,48993,48688,28500,21667,45292,12836,1582,12842,1039,25678,2621,"Cass County, Minnesota(6)",_,_,"Cass County, Minnesota",50.8,24,stable,28706,27,21,50.8,NA
MN,"Chippewa County, Minnesota",1454,571,883,27023,50858,51214,NA,78800,NA,26016,5383,518,5591,468,10974,986,"Chippewa County, Minnesota(6)",_,_,"Chippewa County, Minnesota",29.6,6,stable,12109,27,23,29.6,NA
MN,"Chisago County, Minnesota",2889,1389,1500,27025,71001,71096,57083,78438,76806,51858,24809,1884,24450,1341,49259,3225,"Chisago County, Minnesota(6)",_,_,"Chisago County, Minnesota",44.9,24,falling,54293,27,25,44.9,NA
MN,"Clay County, Minnesota",7202,3333,3869,27027,57965,60174,8333,NA,NA,39500,27578,2300,29120,1387,56698,3687,"Clay County, Minnesota(6)",_,_,"Clay County, Minnesota",42.7,25,stable,62324,27,27,42.7,NA
MN,"Clearwater County, Minnesota",1451,704,747,27029,43421,44715,NA,26250,83750,NA,3809,573,3785,488,7594,1061,"Clearwater County, Minnesota(6)",_,_,"Clearwater County, Minnesota",48.3,6,**,8803,27,29,48.3,NA
MN,"Cook County, Minnesota",588,242,346,27031,52299,55572,NA,32679,NA,NA,2296,290,2368,196,4664,486,"Cook County, Minnesota(6)",_,_,"Cook County, Minnesota",*,*,**,5194,27,31,NA,NA
MN,"Cottonwood County, Minnesota",1905,862,1043,27033,46750,49093,NA,NA,30833,NA,5179,423,5585,249,10764,672,"Cottonwood County, Minnesota(6)",_,_,"Cottonwood County, Minnesota",38.4,7,stable,11549,27,33,38.4,NA
MN,"Crow Wing County, Minnesota",7028,3396,3632,27035,49435,49534,57857,53929,NA,NA,28271,2773,29546,1754,57817,4527,"Crow Wing County, Minnesota(6)",_,_,"Crow Wing County, Minnesota",50.8,47,stable,63428,27,35,50.8,NA
MN,"Dakota County, Minnesota",31270,13735,17535,27037,75567,78766,47428,38646,77558,42576,186300,13285,195459,11601,381759,24886,"Dakota County, Minnesota(6)",_,_,"Dakota County, Minnesota",40.8,148,falling,414686,27,37,40.8,NA
MN,"Dodge County, Minnesota",1342,575,767,27039,68116,68404,NA,88750,NA,54211,9491,582,9571,500,19062,1082,"Dodge County, Minnesota(6)",_,_,"Dodge County, Minnesota",40,8,rising,20364,27,39,40,NA
MN,"Douglas County, Minnesota",3438,1671,1767,27041,54531,54764,NA,45625,NA,NA,16951,1242,17145,892,34096,2134,"Douglas County, Minnesota(6)",_,_,"Douglas County, Minnesota",38.1,21,stable,37075,27,41,38.1,NA
MN,"Faribault County, Minnesota",1878,814,1064,27043,47540,47579,NA,NA,NA,36518,6459,557,6437,466,12896,1023,"Faribault County, Minnesota(6)",_,_,"Faribault County, Minnesota",43.1,10,rising,14050,27,43,43.1,NA
MN,"Fillmore County, Minnesota",2280,1062,1218,27045,51665,51930,21500,63125,35972,26250,9245,1033,9430,806,18675,1839,"Fillmore County, Minnesota(6)",_,_,"Fillmore County, Minnesota",30,10,stable,20834,27,45,30,NA
MN,"Freeborn County, Minnesota",3679,1371,2308,27047,47105,47795,18646,NA,46750,31250,13709,1357,14389,970,28098,2327,"Freeborn County, Minnesota(6)",_,_,"Freeborn County, Minnesota",39.2,19,stable,30613,27,47,39.2,NA
MN,"Goodhue County, Minnesota",5104,2254,2850,27049,57062,57590,21136,NA,NA,40497,20893,1771,21272,1646,42165,3417,"Goodhue County, Minnesota(6)",_,_,"Goodhue County, Minnesota",41.2,26,stable,46435,27,49,41.2,NA
MN,"Grant County, Minnesota",533,209,324,27051,50174,49856,NA,NA,NA,70625,2788,185,2794,134,5582,319,"Grant County, Minnesota(6)",_,_,"Grant County, Minnesota",41.4,4,stable,5903,27,51,41.4,NA
MN,"Hennepin County, Minnesota",146382,68632,77750,27053,65834,72970,28231,29306,73912,42572,531559,53042,563962,39808,1095521,92850,"Hennepin County, Minnesota(6)",_,_,"Hennepin County, Minnesota",35.7,411,falling,1223149,27,53,35.7,NA
MN,"Houston County, Minnesota",2031,1013,1018,27055,53809,54051,NA,46797,NA,41563,8778,546,8804,468,17582,1014,"Houston County, Minnesota(6)",_,_,"Houston County, Minnesota",30.6,9,stable,18773,27,55,30.6,NA
MN,"Hubbard County, Minnesota",2368,1092,1276,27057,47486,48053,NA,29773,87083,45804,9250,975,9560,698,18810,1673,"Hubbard County, Minnesota(6)",_,_,"Hubbard County, Minnesota",46.1,16,stable,20655,27,57,46.1,NA
MN,"Isanti County, Minnesota",2802,1404,1398,27059,59865,60490,NA,2499,132917,68889,17605,1560,17777,1036,35382,2596,"Isanti County, Minnesota(6)",_,_,"Isanti County, Minnesota",45,18,stable,38429,27,59,45,NA
MN,"Itasca County, Minnesota",6018,2849,3169,27061,47761,48083,NA,36667,NA,31438,20410,2134,20142,1898,40552,4032,"Itasca County, Minnesota(6)",_,_,"Itasca County, Minnesota",47.2,32,falling,45435,27,61,47.2,NA
MN,"Jackson County, Minnesota",1085,524,561,27063,50574,51333,NA,NA,35156,35938,4773,334,4757,226,9530,560,"Jackson County, Minnesota(6)",_,_,"Jackson County, Minnesota",27,5,stable,10079,27,63,27,NA
MN,"Kanabec County, Minnesota",2242,1011,1231,27065,47384,47796,NA,34583,NA,34219,7273,765,7292,542,14565,1307,"Kanabec County, Minnesota(6)",_,_,"Kanabec County, Minnesota",36.9,8,stable,15837,27,65,36.9,NA
MN,"Kandiyohi County, Minnesota",4877,2120,2757,27067,52632,54425,15345,53403,32381,37352,19068,1997,19480,1287,38548,3284,"Kandiyohi County, Minnesota(6)",_,_,"Kandiyohi County, Minnesota",40.2,22,stable,42542,27,67,40.2,NA
MN,"Kittson County, Minnesota",474,179,295,27069,52326,52409,NA,NA,NA,55417,2048,173,2015,123,4063,296,"Kittson County, Minnesota(6)",_,_,"Kittson County, Minnesota",*,*,**,4424,27,69,NA,NA
MN,"Koochiching County, Minnesota",1937,956,981,27071,42919,43818,NA,26433,NA,NA,5810,670,5986,427,11796,1097,"Koochiching County, Minnesota(6)",_,_,"Koochiching County, Minnesota",47,10,stable,12841,27,71,47,NA
MN,"Lac qui Parle County, Minnesota",561,250,311,27073,49903,50202,NA,NA,NA,23333,3298,203,3252,145,6550,348,"Lac qui Parle County, Minnesota(6)",_,_,"Lac qui Parle County, Minnesota",37.9,5,stable,6856,27,73,37.9,NA
MN,"Lake County, Minnesota",1364,687,677,27075,48417,49098,NA,68750,NA,NA,5051,326,4860,344,9911,670,"Lake County, Minnesota(6)",_,_,"Lake County, Minnesota",43.7,8,stable,10631,27,75,43.7,NA
MN,"Lake of the Woods County, Minnesota",363,162,201,27077,42263,42038,NA,NA,NA,NA,1792,222,1769,112,3561,334,"Lake of the Woods County, Minnesota(6)",_,_,"Lake of the Woods County, Minnesota",45.6,3,stable,3923,27,77,45.6,NA
MN,"Le Sueur County, Minnesota",2482,1203,1279,27079,60632,60939,NA,25833,56875,43859,13150,806,12839,735,25989,1541,"Le Sueur County, Minnesota(6)",_,_,"Le Sueur County, Minnesota",38,13,stable,27663,27,79,38,NA
MN,"Lincoln County, Minnesota",524,207,317,27081,49575,49750,NA,50139,NA,28281,2669,198,2607,169,5276,367,"Lincoln County, Minnesota(6)",_,_,"Lincoln County, Minnesota",36.2,4,stable,5771,27,81,36.2,NA
MN,"Lyon County, Minnesota",3456,1351,2105,27083,51600,52252,42984,2499,50958,36735,11652,1034,12152,562,23804,1596,"Lyon County, Minnesota(6)",_,_,"Lyon County, Minnesota",37.5,11,stable,25673,27,83,37.5,NA
MN,"McLeod County, Minnesota",2866,1279,1587,27085,56128,56525,NA,NA,NA,47143,16345,1426,16902,1057,33247,2483,"McLeod County, Minnesota(6)",_,_,"McLeod County, Minnesota",40.4,18,stable,35932,27,85,40.4,NA
MN,"Mahnomen County, Minnesota",1350,638,712,27087,41118,49009,NA,28750,NA,27500,2291,464,2243,460,4534,924,"Mahnomen County, Minnesota(6)",_,_,"Mahnomen County, Minnesota",82.7,6,rising,5457,27,87,82.7,NA
MN,"Marshall County, Minnesota",734,286,448,27089,54092,54182,NA,43750,NA,47875,4370,405,4280,330,8650,735,"Marshall County, Minnesota(6)",_,_,"Marshall County, Minnesota",53.6,8,rising,9423,27,89,53.6,NA
MN,"Martin County, Minnesota",2286,870,1416,27091,51391,51136,NA,NA,91071,NA,9251,725,9456,690,18707,1415,"Martin County, Minnesota(6)",_,_,"Martin County, Minnesota",31.1,11,stable,20022,27,91,31.1,NA
MN,"Meeker County, Minnesota",2282,951,1331,27093,55042,55314,26154,NA,NA,28750,10443,1102,10532,754,20975,1856,"Meeker County, Minnesota(6)",_,_,"Meeker County, Minnesota",40.7,13,stable,23102,27,93,40.7,NA
MN,"Mille Lacs County, Minnesota",3080,1382,1698,27095,49094,49830,21750,35192,61250,NA,11568,1188,11699,896,23267,2084,"Mille Lacs County, Minnesota(6)",_,_,"Mille Lacs County, Minnesota",56.2,19,stable,25788,27,95,56.2,NA
MN,"Morrison County, Minnesota",3687,1602,2085,27097,50049,50062,12096,NA,60481,62946,15039,1432,15147,1013,30186,2445,"Morrison County, Minnesota(6)",_,_,"Morrison County, Minnesota",39.6,17,stable,32775,27,97,39.6,NA
MN,"Mower County, Minnesota",5410,2667,2743,27099,49427,50400,34784,8466,61250,37673,17518,1895,18117,1318,35635,3213,"Mower County, Minnesota(6)",_,_,"Mower County, Minnesota",38.5,22,stable,39116,27,99,38.5,NA
MN,"Murray County, Minnesota",771,335,436,27101,51983,52296,NA,NA,NA,24464,3890,299,3905,322,7795,621,"Murray County, Minnesota(6)",_,_,"Murray County, Minnesota",33.5,5,stable,8413,27,101,33.5,NA
MN,"Nicollet County, Minnesota",3814,1884,1930,27103,58640,59802,12708,NA,65972,54219,15555,844,15863,644,31418,1488,"Nicollet County, Minnesota(6)",_,_,"Nicollet County, Minnesota",35.5,12,stable,33347,27,103,35.5,NA
MN,"Nobles County, Minnesota",3320,1569,1751,27105,50625,52012,40152,21250,NA,49118,9434,1648,9187,1130,18621,2778,"Nobles County, Minnesota(6)",_,_,"Nobles County, Minnesota",26.6,8,stable,21770,27,105,26.6,NA
MN,"Norman County, Minnesota",846,383,463,27107,50377,50709,NA,NA,60417,32125,2979,343,3049,195,6028,538,"Norman County, Minnesota(6)",_,_,"Norman County, Minnesota",38.6,5,stable,6678,27,107,38.6,NA
MN,"Olmsted County, Minnesota",13237,5835,7402,27109,68023,69078,31314,66910,82372,48525,66247,5093,71931,3469,138178,8562,"Olmsted County, Minnesota(6)",_,_,"Olmsted County, Minnesota",32.3,50,falling,151436,27,109,32.3,NA
MN,"Otter Tail County, Minnesota",5635,2449,3186,27111,52365,53219,15750,45820,NA,52841,26409,1967,26916,1504,53325,3471,"Otter Tail County, Minnesota(6)",_,_,"Otter Tail County, Minnesota",42,39,stable,57716,27,111,42,NA
MN,"Pennington County, Minnesota",1286,567,719,27113,47127,47149,NA,52917,115655,NA,6487,499,6681,240,13168,739,"Pennington County, Minnesota(6)",_,_,"Pennington County, Minnesota",34,6,stable,14219,27,113,34,NA
MN,"Pine County, Minnesota",4015,1890,2125,27115,44549,45123,NA,26932,49286,31719,12590,1473,12495,1049,25085,2522,"Pine County, Minnesota(6)",_,_,"Pine County, Minnesota",45.4,18,stable,29069,27,115,45.4,NA
MN,"Pipestone County, Minnesota",1182,449,733,27117,46990,47188,NA,27386,NA,45076,3966,479,4408,339,8374,818,"Pipestone County, Minnesota(6)",_,_,"Pipestone County, Minnesota",46.9,6,stable,9271,27,117,46.9,NA
MN,"Polk County, Minnesota",3987,1987,2000,27119,53326,54126,NA,29464,89286,34833,14463,1226,14393,900,28856,2126,"Polk County, Minnesota(6)",_,_,"Polk County, Minnesota",44.2,18,stable,31533,27,119,44.2,NA
MN,"Pope County, Minnesota",1011,431,580,27121,52785,52799,NA,31667,NA,NA,5121,385,5047,219,10168,604,"Pope County, Minnesota(6)",_,_,"Pope County, Minnesota",39.3,7,stable,11041,27,121,39.3,NA
MN,"Ramsey County, Minnesota",84589,38727,45862,27123,56104,62782,27800,36458,47054,37542,228045,26230,249216,19701,477261,45931,"Ramsey County, Minnesota(6)",_,_,"Ramsey County, Minnesota",43,227,falling,538133,27,123,43,NA
MN,"Red Lake County, Minnesota",431,206,225,27125,50332,50918,NA,22917,NA,31250,1872,184,1914,68,3786,252,"Red Lake County, Minnesota(6)",_,_,"Red Lake County, Minnesota",54.2,3,stable,4055,27,125,54.2,NA
MN,"Redwood County, Minnesota",1825,900,925,27127,47211,47872,NA,41667,25000,23750,7054,757,7071,571,14125,1328,"Redwood County, Minnesota(6)",_,_,"Redwood County, Minnesota",43.7,11,stable,15471,27,127,43.7,NA
MN,"Renville County, Minnesota",1646,676,970,27129,52149,53252,2499,51667,NA,40313,7016,563,6798,503,13814,1066,"Renville County, Minnesota(6)",_,_,"Renville County, Minnesota",35.4,8,stable,14892,27,129,35.4,NA
MN,"Rice County, Minnesota",6469,2720,3749,27131,59598,61199,23599,NA,55729,34931,27682,2731,29574,2022,57256,4753,"Rice County, Minnesota(6)",_,_,"Rice County, Minnesota",45,30,stable,65400,27,131,45,NA
MN,"Rock County, Minnesota",1067,431,636,27133,51496,51725,NA,38750,NA,NA,4210,337,4483,312,8693,649,"Rock County, Minnesota(6)",_,_,"Rock County, Minnesota",30.3,5,**,9600,27,133,30.3,NA
MN,"Roseau County, Minnesota",1637,749,888,27135,53199,53498,NA,55144,42000,15357,7498,407,7133,385,14631,792,"Roseau County, Minnesota(6)",_,_,"Roseau County, Minnesota",47.7,9,stable,15770,27,135,47.7,NA
MN,"St. Louis County, Minnesota",30869,14248,16621,27137,48331,49984,15306,24400,29063,49688,91466,7407,93151,5140,184617,12547,"St. Louis County, Minnesota(6)",_,_,"St. Louis County, Minnesota",47,126,stable,200431,27,137,47,NA
MN,"Scott County, Minnesota",7747,3527,4220,27139,87794,88977,85438,59079,84250,54960,63816,4279,64480,3368,128296,7647,"Scott County, Minnesota(6)",_,_,"Scott County, Minnesota",43.8,41,stable,141660,27,139,43.8,NA
MN,"Sherburne County, Minnesota",6966,2952,4014,27141,74170,74745,27833,NA,63986,62971,41926,2684,42301,1600,84227,4284,"Sherburne County, Minnesota(6)",_,_,"Sherburne County, Minnesota",43.2,30,stable,91705,27,141,43.2,NA
MN,"Sibley County, Minnesota",1584,699,885,27143,56990,57450,NA,NA,NA,42031,7125,445,6891,431,14016,876,"Sibley County, Minnesota(6)",_,_,"Sibley County, Minnesota",45.6,9,stable,14875,27,143,45.6,NA
MN,"Stearns County, Minnesota",19570,9275,10295,27145,56336,57938,26019,41071,42215,31556,70278,5627,71882,3644,142160,9271,"Stearns County, Minnesota(6)",_,_,"Stearns County, Minnesota",35.2,55,falling,154708,27,145,35.2,NA
MN,"Steele County, Minnesota",3721,1400,2321,27147,57858,59627,30000,NA,50795,47097,16659,1065,17658,754,34317,1819,"Steele County, Minnesota(6)",_,_,"Steele County, Minnesota",33.3,15,stable,36755,27,147,33.3,NA
MN,"Stevens County, Minnesota",1727,895,832,27149,52302,52488,NA,23636,NA,NA,4668,219,4615,184,9283,403,"Stevens County, Minnesota(6)",_,_,"Stevens County, Minnesota",*,*,*,9796,27,149,NA,NA
MN,"Swift County, Minnesota",1167,397,770,27151,49035,50305,NA,NA,NA,45556,4446,326,4412,204,8858,530,"Swift County, Minnesota(6)",_,_,"Swift County, Minnesota",56.1,8,stable,9340,27,151,56.1,NA
MN,"Todd County, Minnesota",3548,1677,1871,27153,46414,46225,NA,NA,NA,40547,10868,1518,10527,1372,21395,2890,"Todd County, Minnesota(6)",_,_,"Todd County, Minnesota",38,13,falling,24257,27,153,38,NA
MN,"Traverse County, Minnesota",341,139,202,27155,49186,50029,NA,NA,NA,NA,1586,79,1623,53,3209,132,"Traverse County, Minnesota(6)",_,_,"Traverse County, Minnesota",*,*,**,3401,27,155,NA,NA
MN,"Wabasha County, Minnesota",1547,742,805,27157,56510,56914,NA,NA,53750,37228,10047,612,10101,434,20148,1046,"Wabasha County, Minnesota(6)",_,_,"Wabasha County, Minnesota",48.6,14,stable,21239,27,157,48.6,NA
MN,"Wadena County, Minnesota",2211,979,1232,27159,41906,42500,101094,NA,NA,36500,6044,661,6338,424,12382,1085,"Wadena County, Minnesota(6)",_,_,"Wadena County, Minnesota",43.8,10,stable,13875,27,159,43.8,NA
MN,"Waseca County, Minnesota",1544,752,792,27161,53564,55830,21652,NA,22885,NA,8524,560,8332,512,16856,1072,"Waseca County, Minnesota(6)",_,_,"Waseca County, Minnesota",48.1,11,stable,18989,27,161,48.1,NA
MN,"Washington County, Minnesota",13109,5830,7279,27163,83706,84106,71989,72031,102145,50737,112949,6485,119396,4682,232345,11167,"Washington County, Minnesota(6)",_,_,"Washington County, Minnesota",40.2,91,falling,251597,27,163,40.2,NA
MN,"Watonwan County, Minnesota",1182,351,831,27165,50604,50693,NA,NA,NA,47500,4631,777,4882,629,9513,1406,"Watonwan County, Minnesota(6)",_,_,"Watonwan County, Minnesota",46.5,8,stable,10952,27,165,46.5,NA
MN,"Wilkin County, Minnesota",627,219,408,27167,51476,51867,NA,58092,NA,54000,3036,206,2959,173,5995,379,"Wilkin County, Minnesota(6)",_,_,"Wilkin County, Minnesota",*,*,**,6396,27,167,NA,NA
MN,"Winona County, Minnesota",6933,3476,3457,27169,50547,50999,11108,36150,101625,58241,22371,2613,24235,1509,46606,4122,"Winona County, Minnesota(6)",_,_,"Winona County, Minnesota",37.8,22,stable,50885,27,169,37.8,NA
MN,"Wright County, Minnesota",7846,3355,4491,27171,73557,73754,47813,30179,73625,57705,60440,3886,60402,3171,120842,7057,"Wright County, Minnesota(6)",_,_,"Wright County, Minnesota",42.5,44,stable,131311,27,171,42.5,NA
MN,"Yellow Medicine County, Minnesota",1175,588,587,27173,53041,53519,NA,42917,NA,41000,4645,462,4459,344,9104,806,"Yellow Medicine County, Minnesota(6)",_,_,"Yellow Medicine County, Minnesota",42.7,6,stable,9875,27,173,42.7,NA
MO,"Adair County, Missouri",6105,2917,3188,29001,37516,39643,16696,8496,2499,13228,10824,1177,11811,1435,22635,2612,"Adair County, Missouri(6,10)",57.8,15,"Adair County, Missouri",43.1,12,stable,25378,29,1,43.1,57.8
MO,"Andrew County, Missouri",1531,828,703,29003,55613,55932,41055,64178,NA,40391,7657,827,8051,579,15708,1406,"Andrew County, Missouri(6,10)",50.5,11,"Andrew County, Missouri",37.9,9,stable,17296,29,3,37.9,50.5
MO,"Atchison County, Missouri",693,298,395,29005,43933,44573,NA,NA,20962,93750,2268,394,2392,287,4660,681,"Atchison County, Missouri(6,10)",71,7,"Atchison County, Missouri",58.1,6,stable,5306,29,5,58.1,71
MO,"Audrain County, Missouri",4401,2030,2371,29007,41310,42541,23938,NA,NA,32353,9791,1853,10925,1539,20716,3392,"Audrain County, Missouri(6,10)",90.1,29,"Audrain County, Missouri",63.3,21,stable,26096,29,7,63.3,90.1
MO,"Barry County, Missouri",7072,3303,3769,29009,39033,39075,NA,48750,35938,37436,14276,3505,14770,2880,29046,6385,"Barry County, Missouri(6,10)",77.4,39,"Barry County, Missouri",60.1,31,stable,35829,29,9,60.1,77.4
MO,"Barton County, Missouri",2910,1329,1581,29011,37467,37980,NA,38125,NA,30326,5177,780,5425,668,10602,1448,"Barton County, Missouri(6,10)",67.2,12,"Barton County, Missouri",49.1,9,falling,11880,29,11,49.1,67.2
MO,"Bates County, Missouri",2996,1355,1641,29013,41060,41683,35913,NA,NA,43261,6891,1119,7239,1100,14130,2219,"Bates County, Missouri(6,10)",80.8,19,"Bates County, Missouri",62,15,stable,16446,29,13,62,80.8
MO,"Benton County, Missouri",3540,1492,2048,29015,33042,33328,NA,27857,NA,28802,8015,1303,8169,1163,16184,2466,"Benton County, Missouri(6,10)",89.1,33,"Benton County, Missouri",66.7,24,stable,18670,29,15,66.7,89.1
MO,"Bollinger County, Missouri",2654,1198,1456,29017,39707,40323,NA,NA,25750,NA,5313,833,5358,766,10671,1599,"Bollinger County, Missouri(6,10)",96.4,16,"Bollinger County, Missouri",72.5,12,stable,12182,29,17,72.5,96.4
MO,"Boone County, Missouri",31824,14224,17600,29019,49899,52249,28734,31098,34406,41598,74337,7488,81131,6446,155468,13934,"Boone County, Missouri(6,10)",63.4,86,"Boone County, Missouri",47.2,63,falling,174974,29,19,47.2,63.4
MO,"Buchanan County, Missouri",15456,7270,8186,29021,46315,47342,31925,NA,55583,37043,35906,6568,38780,5467,74686,12035,"Buchanan County, Missouri(6,10)",86.8,88,"Buchanan County, Missouri",65.1,67,stable,89100,29,21,65.1,86.8
MO,"Butler County, Missouri",8942,3780,5162,29023,35738,36734,25762,49286,NA,31042,17314,3107,19400,2516,36714,5623,"Butler County, Missouri(6,10)",95.7,56,"Butler County, Missouri",78.3,46,stable,42951,29,23,78.3,95.7
MO,"Caldwell County, Missouri",1186,487,699,29025,43691,42852,NA,NA,NA,63482,3960,481,4001,453,7961,934,"Caldwell County, Missouri(6,10)",89.3,11,"Caldwell County, Missouri",75.2,10,stable,9014,29,25,75.2,89.3
MO,"Callaway County, Missouri",5865,2577,3288,29027,47744,48881,23140,64464,61603,NA,18353,2151,19311,2318,37664,4469,"Callaway County, Missouri(6,10)",79.4,39,"Callaway County, Missouri",54.3,26,stable,44834,29,27,54.3,79.4
MO,"Camden County, Missouri",7516,3496,4020,29029,44816,45256,NA,NA,NA,16121,17731,3647,18484,3655,36215,7302,"Camden County, Missouri(6,10)",68.6,51,"Camden County, Missouri",47.4,35,stable,44237,29,29,47.4,68.6
MO,"Cape Girardeau County, Missouri",13626,6203,7423,29031,46050,48762,18837,45583,NA,28361,33392,3674,35954,3535,69346,7209,"Cape Girardeau County, Missouri(6,10)",70.1,62,"Cape Girardeau County, Missouri",56.6,50,stable,78572,29,31,56.6,70.1
MO,"Carroll County, Missouri",1273,555,718,29033,42415,43854,NA,NA,NA,NA,3922,437,4094,549,8016,986,"Carroll County, Missouri(6,10)",94.6,13,"Carroll County, Missouri",63.4,9,stable,8992,29,33,63.4,94.6
MO,"Carter County, Missouri",1319,613,706,29035,33034,33765,NA,2499,NA,40536,2380,608,2712,551,5092,1159,"Carter County, Missouri(6,10)",110,9,"Carter County, Missouri",92.3,8,stable,6263,29,35,92.3,110
MO,"Cass County, Missouri",9805,3862,5943,29037,61584,61169,64260,61750,91161,52148,43701,5306,46476,4398,90177,9704,"Cass County, Missouri(6,10)",70.1,81,"Cass County, Missouri",53.8,63,falling,101603,29,37,53.8,70.1
MO,"Cedar County, Missouri",3381,1827,1554,29039,31532,31765,NA,NA,NA,NA,5604,1255,5514,1376,11118,2631,"Cedar County, Missouri(6,10)",78.3,17,"Cedar County, Missouri",56.7,13,stable,13934,29,39,56.7,78.3
MO,"Chariton County, Missouri",1213,572,641,29041,40642,41181,23833,35000,NA,33750,3427,307,3430,269,6857,576,"Chariton County, Missouri(6,10)",67.7,8,"Chariton County, Missouri",50,6,stable,7589,29,41,50,67.7
MO,"Christian County, Missouri",8879,3800,5079,29043,53270,53252,36563,77308,NA,40920,33745,5297,36471,4930,70216,10227,"Christian County, Missouri(6,10)",63,53,"Christian County, Missouri",45.9,37,falling,83279,29,43,45.9,63
MO,"Clark County, Missouri",928,459,469,29045,43883,44467,NA,37321,NA,NA,2926,543,2883,497,5809,1040,"Clark County, Missouri(6,10)",95.2,9,"Clark County, Missouri",67.8,7,stable,6801,29,45,67.8,95.2
MO,"Clay County, Missouri",20137,9091,11046,29047,62099,63678,41523,65202,67212,54515,99877,12035,105832,11096,205709,23131,"Clay County, Missouri(6,10)",79,173,"Clay County, Missouri",55.7,122,falling,235637,29,47,55.7,79
MO,"Clinton County, Missouri",1856,763,1093,29049,54773,55192,34450,36157,72386,45806,8726,1260,8835,1212,17561,2472,"Clinton County, Missouri(6,10)",83.5,22,"Clinton County, Missouri",59.3,15,stable,20609,29,49,59.3,83.5
MO,"Cole County, Missouri",9237,4466,4771,29051,53088,56494,28977,31417,60521,37941,31386,3738,34245,3179,65631,6917,"Cole County, Missouri(6,10)",64,53,"Cole County, Missouri",45.3,37,stable,76720,29,51,45.3,64
MO,"Cooper County, Missouri",2354,1129,1225,29053,44549,46331,16568,NA,104107,51250,6966,1006,7347,725,14313,1731,"Cooper County, Missouri(6,10)",69,15,"Cooper County, Missouri",51.3,11,stable,17642,29,53,51.3,69
MO,"Crawford County, Missouri",5093,2385,2708,29055,36743,36935,NA,NA,NA,25536,9853,2166,10515,1841,20368,4007,"Crawford County, Missouri(6,10)",93.1,30,"Crawford County, Missouri",75,24,stable,24526,29,55,75,93.1
MO,"Dade County, Missouri",1473,738,735,29057,37035,37407,NA,NA,NA,24792,3152,649,3070,613,6222,1262,"Dade County, Missouri(6,10)",83.3,10,"Dade County, Missouri",58.4,7,stable,7595,29,57,58.4,83.3
MO,"Dallas County, Missouri",3577,1685,1892,29059,38062,38663,NA,NA,NA,54015,6336,1862,6412,1760,12748,3622,"Dallas County, Missouri(6,10)",79.2,18,"Dallas County, Missouri",55.9,13,stable,16393,29,59,55.9,79.2
MO,"Daviess County, Missouri",1340,567,773,29061,41642,41627,NA,NA,NA,39375,3130,916,3150,881,6280,1797,"Daviess County, Missouri(6,10)",75,9,"Daviess County, Missouri",58.9,7,stable,8253,29,61,58.9,75
MO,"DeKalb County, Missouri",1391,636,755,29063,41406,41309,NA,NA,NA,13946,4219,527,4212,393,8431,920,"DeKalb County, Missouri(6,10)",39.5,6,"DeKalb County, Missouri",38.4,6,stable,12687,29,63,38.4,39.5
MO,"Dent County, Missouri",3642,1575,2067,29065,36831,37297,NA,NA,NA,24500,6000,1568,6542,1327,12542,2895,"Dent County, Missouri(6,10)",74.4,17,"Dent County, Missouri",62.9,14,stable,15593,29,65,62.9,74.4
MO,"Douglas County, Missouri",2941,1441,1500,29067,30508,30627,NA,NA,NA,NA,5437,1236,5560,1160,10997,2396,"Douglas County, Missouri(6,10)",51.9,11,"Douglas County, Missouri",46.7,10,stable,13373,29,67,46.7,51.9
MO,"Dunklin County, Missouri",8536,3850,4686,29069,31077,32203,22269,NA,NA,34145,12334,2629,13394,2534,25728,5163,"Dunklin County, Missouri(6,10)",100.1,41,"Dunklin County, Missouri",81.2,33,stable,30895,29,69,81.2,100.1
MO,"Franklin County, Missouri",11941,5839,6102,29071,48480,48655,NA,87837,78819,NA,44984,5261,45939,4878,90923,10139,"Franklin County, Missouri(6,10)",76.9,92,"Franklin County, Missouri",54.4,64,stable,102426,29,71,54.4,76.9
MO,"Gasconade County, Missouri",2316,1157,1159,29073,42826,43062,NA,NA,NA,NA,6544,770,6742,619,13286,1389,"Gasconade County, Missouri(6,10)",64,15,"Gasconade County, Missouri",38,9,falling,14858,29,73,38,64
MO,"Gentry County, Missouri",1119,497,622,29075,41912,42132,NA,NA,NA,NA,2818,397,3044,362,5862,759,"Gentry County, Missouri(6,10)",66.3,7,"Gentry County, Missouri",54.1,6,stable,6692,29,75,54.1,66.3
MO,"Greene County, Missouri",51533,22824,28709,29077,41227,42115,29896,45140,28311,33079,114052,21695,125498,18123,239550,39818,"Greene County, Missouri(6,10)",69.8,220,"Greene County, Missouri",51.3,162,falling,288072,29,77,51.3,69.8
MO,"Grundy County, Missouri",2020,900,1120,29079,37656,37941,NA,81563,NA,NA,4033,812,4472,755,8505,1567,"Grundy County, Missouri(6,10)",71.9,11,"Grundy County, Missouri",55.6,9,stable,10097,29,79,55.6,71.9
MO,"Harrison County, Missouri",1485,676,809,29081,39301,39569,NA,NA,NA,40556,3585,681,3697,573,7282,1254,"Harrison County, Missouri(6,10)",79.6,11,"Harrison County, Missouri",55.6,8,stable,8615,29,81,55.6,79.6
MO,"Henry County, Missouri",4131,1852,2279,29083,42181,42236,68833,70020,NA,NA,9081,1570,9737,1406,18818,2976,"Henry County, Missouri(6,10)",100.3,33,"Henry County, Missouri",83.6,28,stable,21737,29,83,83.6,100.3
MO,"Hickory County, Missouri",2394,992,1402,29085,32122,32780,NA,20208,NA,NA,3643,917,3872,822,7515,1739,"Hickory County, Missouri(6,10)",73.4,16,"Hickory County, Missouri",62,13,stable,9201,29,85,62,73.4
MO,"Holt County, Missouri",555,269,286,29087,42500,43222,NA,NA,NA,48750,1970,278,1969,281,3939,559,"Holt County, Missouri(6,10)",68.3,5,"Holt County, Missouri",43.1,3,**,4484,29,87,43.1,68.3
MO,"Howard County, Missouri",1587,768,819,29089,44820,46544,41250,21429,NA,NA,4509,504,4607,435,9116,939,"Howard County, Missouri(6,10)",54.6,7,"Howard County, Missouri",39.9,5,stable,10139,29,89,39.9,54.6
MO,"Howell County, Missouri",9158,4270,4888,29091,32784,32650,NA,15455,NA,NA,16754,2599,18027,2511,34781,5110,"Howell County, Missouri(6,10)",81.4,44,"Howell County, Missouri",65,36,falling,40117,29,91,65,81.4
MO,"Iron County, Missouri",2293,1090,1203,29093,36239,36659,22917,20938,NA,105625,4038,863,4303,775,8341,1638,"Iron County, Missouri(6,10)",103.3,16,"Iron County, Missouri",58.5,9,stable,10125,29,93,58.5,103.3
MO,"Jackson County, Missouri",119678,53111,66567,29095,46869,54974,31492,30028,49490,34168,274189,51746,301575,46734,575764,98480,"Jackson County, Missouri(6,10)",75.3,542,"Jackson County, Missouri",55.3,398,falling,687623,29,95,55.3,75.3
MO,"Jasper County, Missouri",19556,8607,10949,29097,41811,42224,25515,35250,NA,35396,47538,9084,50298,9147,97836,18231,"Jasper County, Missouri(6,10)",85.8,109,"Jasper County, Missouri",60.7,78,stable,118596,29,97,60.7,85.8
MO,"Jefferson County, Missouri",23937,11024,12913,29099,55348,55751,38389,38500,83750,52917,97569,11891,100070,10451,197639,22342,"Jefferson County, Missouri(6,10)",85.9,195,"Jefferson County, Missouri",71.6,157,falling,224124,29,99,71.6,85.9
MO,"Johnson County, Missouri",8407,4131,4276,29101,49792,50856,40158,31541,47989,41678,22043,2750,23188,2558,45231,5308,"Johnson County, Missouri(6,10)",66.1,33,"Johnson County, Missouri",54.1,26,stable,53951,29,101,54.1,66.1
MO,"Knox County, Missouri",823,384,439,29103,38289,38365,NA,NA,NA,39792,1561,424,1540,433,3101,857,"Knox County, Missouri(6,10)",92.7,6,"Knox County, Missouri",81.5,5,**,3910,29,103,81.5,92.7
MO,"Laclede County, Missouri",6816,3199,3617,29105,39712,40029,NA,61118,2499,44762,14481,2881,14812,2946,29293,5827,"Laclede County, Missouri(6,10)",76.5,35,"Laclede County, Missouri",60.9,27,falling,35473,29,105,60.9,76.5
MO,"Lafayette County, Missouri",3706,1584,2122,29107,50723,51152,38971,NA,NA,33125,14263,1786,14908,1447,29171,3233,"Lafayette County, Missouri(6,10)",73.9,32,"Lafayette County, Missouri",50.1,21,stable,32701,29,107,50.1,73.9
MO,"Lawrence County, Missouri",7052,3252,3800,29109,40597,40735,NA,45938,74519,35231,15755,2885,16235,2782,31990,5667,"Lawrence County, Missouri(6,10)",66.5,34,"Lawrence County, Missouri",53.7,27,stable,38180,29,109,53.7,66.5
MO,"Lewis County, Missouri",1215,532,683,29111,43909,43913,39500,NA,NA,51793,4568,481,4372,548,8940,1029,"Lewis County, Missouri(6,10)",79.9,11,"Lewis County, Missouri",68.9,9,stable,10207,29,111,68.9,79.9
MO,"Lincoln County, Missouri",7980,3595,4385,29113,53718,54425,42428,NA,16453,NA,23642,2898,23748,3079,47390,5977,"Lincoln County, Missouri(6,10)",87.7,45,"Lincoln County, Missouri",67.8,35,stable,54696,29,113,67.8,87.7
MO,"Linn County, Missouri",2196,1008,1188,29115,37997,38542,32500,NA,NA,20227,5065,811,5529,919,10594,1730,"Linn County, Missouri(6,10)",91.5,17,"Linn County, Missouri",65.6,12,stable,12308,29,115,65.6,91.5
MO,"Livingston County, Missouri",2273,954,1319,29117,43350,43799,NA,87969,NA,25430,5604,965,6401,794,12005,1759,"Livingston County, Missouri(6,10)",86.8,18,"Livingston County, Missouri",70.4,15,rising,15028,29,117,70.4,86.8
MO,"McDonald County, Missouri",4876,2218,2658,29119,38368,39301,16350,26875,29839,32448,8953,2573,8596,2482,17549,5055,"McDonald County, Missouri(6,10)",77.8,19,"McDonald County, Missouri",80.6,19,stable,22643,29,119,80.6,77.8
MO,"Macon County, Missouri",2895,1311,1584,29121,36976,37386,17466,NA,88500,16081,6564,896,6670,1058,13234,1954,"Macon County, Missouri(6,10)",41.9,10,"Macon County, Missouri",40.9,10,stable,15335,29,121,40.9,41.9
MO,"Madison County, Missouri",2238,888,1350,29123,35097,34890,NA,NA,NA,NA,4999,953,5528,752,10527,1705,"Madison County, Missouri(6,10)",106.8,19,"Madison County, Missouri",98.5,17,stable,12408,29,123,98.5,106.8
MO,"Maries County, Missouri",1721,883,838,29125,39700,40221,NA,74844,NA,NA,3874,585,3844,630,7718,1215,"Maries County, Missouri(6,10)",60.4,8,"Maries County, Missouri",72.6,9,stable,8963,29,125,72.6,60.4
MO,"Marion County, Missouri",5020,2181,2839,29127,40814,41656,31304,NA,71500,NA,11569,1990,12609,1996,24178,3986,"Marion County, Missouri(6,10)",87.9,33,"Marion County, Missouri",58.6,22,stable,28880,29,127,58.6,87.9
MO,"Mercer County, Missouri",584,269,315,29129,40768,41031,NA,NA,NA,NA,1438,395,1507,322,2945,717,"Mercer County, Missouri(6,10)",114.1,7,"Mercer County, Missouri",74.2,4,**,3694,29,129,74.2,114.1
MO,"Miller County, Missouri",4942,2218,2724,29131,38094,39131,NA,23113,NA,16721,10355,1786,10929,1608,21284,3394,"Miller County, Missouri(6,10)",88.8,28,"Miller County, Missouri",68.4,22,rising,25113,29,131,68.4,88.8
MO,"Mississippi County, Missouri",3642,1370,2272,29133,28347,34033,20508,NA,NA,NA,4754,1288,5250,1214,10004,2502,"Mississippi County, Missouri(6,10)",100,18,"Mississippi County, Missouri",97.2,17,stable,14036,29,133,97.2,100
MO,"Moniteau County, Missouri",1885,896,989,29135,47725,47576,NA,NA,NA,66250,5859,1191,6205,1222,12064,2413,"Moniteau County, Missouri(6,10)",54.6,10,"Moniteau County, Missouri",46.6,8,stable,15963,29,135,46.6,54.6
MO,"Monroe County, Missouri",1260,621,639,29137,43138,43250,NA,44375,53750,NA,3677,648,3682,566,7359,1214,"Monroe County, Missouri(6,10)",77.2,10,"Monroe County, Missouri",44.1,6,stable,8583,29,137,44.1,77.2
MO,"Montgomery County, Missouri",2025,923,1102,29139,39830,40322,26719,NA,NA,16667,4996,786,5140,676,10136,1462,"Montgomery County, Missouri(6,10)",83,14,"Montgomery County, Missouri",50.7,9,stable,11703,29,139,50.7,83
MO,"Morgan County, Missouri",4757,2515,2242,29141,33525,34045,NA,NA,NA,62634,7732,2303,7555,2318,15287,4621,"Morgan County, Missouri(6,10)",85,29,"Morgan County, Missouri",65.6,23,stable,20171,29,141,65.6,85
MO,"New Madrid County, Missouri",4094,1799,2295,29143,33630,37295,21612,NA,NA,43333,7092,1596,7626,1728,14718,3324,"New Madrid County, Missouri(6,10)",112.7,28,"New Madrid County, Missouri",84.5,21,stable,18208,29,143,84.5,112.7
MO,"Newton County, Missouri",8377,3814,4563,29145,43290,43572,42438,32173,46627,22381,24386,4432,24757,4545,49143,8977,"Newton County, Missouri(6,10)",57.8,42,"Newton County, Missouri",55.5,40,falling,58615,29,145,55.5,57.8
MO,"Nodaway County, Missouri",5682,2463,3219,29147,35854,36329,NA,NA,21667,NA,9723,1143,10229,1189,19952,2332,"Nodaway County, Missouri(6,10)",73.5,18,"Nodaway County, Missouri",48.7,12,stable,22810,29,147,48.7,73.5
MO,"Oregon County, Missouri",2824,1355,1469,29149,29851,30494,NA,12500,NA,NA,4449,885,4581,930,9030,1815,"Oregon County, Missouri(6,10)",65.2,12,"Oregon County, Missouri",40.7,7,stable,10953,29,149,40.7,65.2
MO,"Osage County, Missouri",1139,603,536,29151,52693,52886,NA,NA,NA,NA,6519,641,6123,336,12642,977,"Osage County, Missouri(6,10)",59.6,10,"Osage County, Missouri",41.5,7,stable,13628,29,151,41.5,59.6
MO,"Ozark County, Missouri",2292,1023,1269,29153,31399,31765,NA,NA,NA,8944,3965,858,3938,719,7903,1577,"Ozark County, Missouri(6,10)",78.9,14,"Ozark County, Missouri",61.6,11,stable,9409,29,153,61.6,78.9
MO,"Pemiscot County, Missouri",5068,2070,2998,29155,29238,35411,15571,NA,NA,49023,6879,1462,7736,1580,14615,3042,"Pemiscot County, Missouri(6,10)",88.6,19,"Pemiscot County, Missouri",90.5,19,stable,17482,29,155,90.5,88.6
MO,"Perry County, Missouri",1798,765,1033,29157,51499,51614,NA,NA,NA,33594,8633,751,8765,658,17398,1409,"Perry County, Missouri(6,10)",75.1,18,"Perry County, Missouri",53.2,13,stable,19183,29,157,53.2,75.1
MO,"Pettis County, Missouri",7484,3292,4192,29159,39928,40686,40724,20938,NA,29663,16923,3233,18256,3036,35179,6269,"Pettis County, Missouri(6,10)",71.2,35,"Pettis County, Missouri",55.3,27,stable,42255,29,159,55.3,71.2
MO,"Phelps County, Missouri",8137,4289,3848,29161,41618,42626,11517,58030,41504,30286,20113,2833,18995,2189,39108,5022,"Phelps County, Missouri(6,10)",71.7,36,"Phelps County, Missouri",51.7,26,stable,44794,29,161,51.7,71.7
MO,"Pike County, Missouri",2482,1017,1465,29163,41750,42899,32550,41563,NA,26250,6882,1238,7243,908,14125,2146,"Pike County, Missouri(6,10)",94.3,22,"Pike County, Missouri",57,13,stable,18348,29,163,57,94.3
MO,"Platte County, Missouri",7106,2824,4282,29165,68254,70496,45786,76375,59122,61890,41729,3706,43224,3804,84953,7510,"Platte County, Missouri(6,10)",59.8,56,"Platte County, Missouri",44.2,40,falling,96096,29,165,44.2,59.8
MO,"Polk County, Missouri",5515,2420,3095,29167,41130,41725,2499,21187,NA,48636,13045,1922,13745,1993,26790,3915,"Polk County, Missouri(6,10)",66,26,"Polk County, Missouri",54,21,stable,31229,29,167,54,66
MO,"Pulaski County, Missouri",5781,2598,3183,29169,47931,48184,48920,NA,78450,45300,16880,2934,17970,2288,34850,5222,"Pulaski County, Missouri(6,10)",103.4,35,"Pulaski County, Missouri",67.9,23,stable,53221,29,169,67.9,103.4
MO,"Putnam County, Missouri",926,444,482,29171,36346,36212,NA,NA,NA,NA,2057,382,2040,363,4097,745,"Putnam County, Missouri(6,10)",92.9,7,"Putnam County, Missouri",63.3,5,stable,4858,29,171,63.3,92.9
MO,"Ralls County, Missouri",1254,511,743,29173,47345,47413,41875,NA,NA,NA,4421,700,4473,595,8894,1295,"Ralls County, Missouri(6,10)",67,9,"Ralls County, Missouri",65.7,9,stable,10196,29,173,65.7,67
MO,"Randolph County, Missouri",4395,1944,2451,29175,37832,39595,15709,NA,NA,NA,9737,1641,10388,1432,20125,3073,"Randolph County, Missouri(6,10)",84.8,25,"Randolph County, Missouri",62.8,18,stable,25104,29,175,62.8,84.8
MO,"Ray County, Missouri",3598,1755,1843,29177,52526,52587,NA,108200,250001,50625,10234,1135,10395,986,20629,2121,"Ray County, Missouri(6,10)",92.8,27,"Ray County, Missouri",77.3,22,stable,22810,29,177,77.3,92.8
MO,"Reynolds County, Missouri",1361,658,703,29179,35648,36265,NA,15938,NA,NA,2900,383,2725,436,5625,819,"Reynolds County, Missouri(6,10)",68.4,7,"Reynolds County, Missouri",59.6,6,stable,6432,29,179,59.6,68.4
MO,"Ripley County, Missouri",3167,1376,1791,29181,32444,33000,NA,NA,NA,NA,5641,1250,5926,1100,11567,2350,"Ripley County, Missouri(6,10)",95,20,"Ripley County, Missouri",82,17,stable,13802,29,181,82,95
MO,"St. Charles County, Missouri",23022,10046,12976,29183,72415,72967,55829,63958,86996,66224,170019,13371,177309,12345,347328,25716,"St. Charles County, Missouri(6,10)",73.7,264,"St. Charles County, Missouri",50,176,falling,385590,29,183,50,73.7
MO,"St. Clair County, Missouri",2156,1042,1114,29185,32046,32110,NA,23750,NA,54318,3806,881,3809,792,7615,1673,"St. Clair County, Missouri(6,10)",73.6,13,"St. Clair County, Missouri",66.6,12,stable,9440,29,185,66.6,73.6
MO,"Ste. Genevieve County, Missouri",2540,925,1615,29186,47014,46981,16767,NA,NA,25313,8552,418,8046,767,16598,1185,"Ste. Genevieve County, Missouri(6,10)",53.6,13,"Ste. Genevieve County, Missouri",62.5,15,stable,17919,29,186,62.5,53.6
MO,"St. Francois County, Missouri",11138,4933,6205,29187,39741,39960,20662,NA,NA,16335,24374,4136,26292,3638,50666,7774,"St. Francois County, Missouri(6,10)",106.8,82,"St. Francois County, Missouri",76.7,59,stable,66520,29,187,76.7,106.8
MO,"St. Louis County, Missouri",106821,44437,62384,29189,59755,68469,38698,42890,82545,48561,423435,45306,477858,42847,901293,88153,"St. Louis County, Missouri(6,10)",69,854,"St. Louis County, Missouri",45.9,574,falling,1003362,29,189,45.9,69
MO,"Saline County, Missouri",3808,1786,2022,29195,40101,40827,26699,NA,NA,37056,10359,1083,10451,987,20810,2070,"Saline County, Missouri(6,10)",74.3,22,"Saline County, Missouri",52.1,16,stable,23258,29,195,52.1,74.3
MO,"Schuyler County, Missouri",914,407,507,29197,37500,37500,NA,NA,NA,NA,1662,454,1855,372,3517,826,"Schuyler County, Missouri(6,10)",64.2,4,"Schuyler County, Missouri",70,4,stable,4436,29,197,70,64.2
MO,"Scotland County, Missouri",730,279,451,29199,39772,39798,NA,NA,NA,NA,1613,778,1806,581,3419,1359,"Scotland County, Missouri(6,10)",58,4,"Scotland County, Missouri",53.8,4,**,4854,29,199,53.8,58
MO,"Scott County, Missouri",7492,3283,4209,29201,39162,41102,28083,NA,NA,28250,16351,2471,17253,2522,33604,4993,"Scott County, Missouri(6,10)",99,49,"Scott County, Missouri",73.8,36,stable,39008,29,201,73.8,99
MO,"Shannon County, Missouri",1938,808,1130,29203,32404,34736,NA,21311,NA,NA,3358,716,3501,678,6859,1394,"Shannon County, Missouri(6,10)",70.3,9,"Shannon County, Missouri",57.8,7,stable,8258,29,203,57.8,70.3
MO,"Shelby County, Missouri",1092,466,626,29205,39087,39247,NA,NA,NA,NA,2474,497,2554,447,5028,944,"Shelby County, Missouri(6,10)",71.9,7,"Shelby County, Missouri",39.6,3,stable,6128,29,205,39.6,71.9
MO,"Stoddard County, Missouri",4583,1898,2685,29207,38203,38544,30461,NA,NA,46250,12035,2363,12921,2117,24956,4480,"Stoddard County, Missouri(6,10)",93.4,39,"Stoddard County, Missouri",71.2,30,stable,29862,29,207,71.2,93.4
MO,"Stone County, Missouri",5147,2154,2993,29209,40510,40720,NA,21458,NA,39907,12806,2449,13343,2523,26149,4972,"Stone County, Missouri(6,10)",66.5,39,"Stone County, Missouri",50,28,stable,30943,29,209,50,66.5
MO,"Sullivan County, Missouri",1066,407,659,29211,40197,39549,63750,NA,75000,43281,2783,488,2689,495,5472,983,"Sullivan County, Missouri(6,10)",88.6,8,"Sullivan County, Missouri",54.6,5,stable,6353,29,211,54.6,88.6
MO,"Taney County, Missouri",9825,4609,5216,29213,38357,38264,46223,52969,NA,32845,20078,5674,21802,5549,41880,11223,"Taney County, Missouri(6,10)",80.6,58,"Taney County, Missouri",52.4,38,stable,54592,29,213,52.4,80.6
MO,"Texas County, Missouri",5214,2506,2708,29215,35088,35268,NA,50313,NA,NA,9999,1996,10373,1902,20372,3898,"Texas County, Missouri(6,10)",71,26,"Texas County, Missouri",56.1,21,stable,25690,29,215,56.1,71
MO,"Vernon County, Missouri",3764,1645,2119,29217,40693,40493,NA,NA,NA,8750,7993,1875,8945,1590,16938,3465,"Vernon County, Missouri(6,10)",75.9,21,"Vernon County, Missouri",61.9,17,stable,20826,29,217,61.9,75.9
MO,"Warren County, Missouri",4507,2131,2376,29219,51133,52289,30733,75417,NA,30699,14369,2102,14662,1732,29031,3834,"Warren County, Missouri(6,10)",76,30,"Warren County, Missouri",56.9,22,stable,33513,29,219,56.9,76
MO,"Washington County, Missouri",5030,2223,2807,29221,35305,35410,10536,14219,NA,NA,10110,1857,10145,1849,20255,3706,"Washington County, Missouri(6,10)",93,28,"Washington County, Missouri",81.1,24,stable,24788,29,221,81.1,93
MO,"Wayne County, Missouri",2960,1342,1618,29223,33750,34215,NA,NA,NA,NA,5477,1115,5609,1054,11086,2169,"Wayne County, Missouri(6,10)",114.9,25,"Wayne County, Missouri",87.9,19,stable,13405,29,223,87.9,114.9
MO,"Webster County, Missouri",6733,3198,3535,29225,44451,44887,NA,44583,85833,42682,14141,3790,14511,3378,28652,7168,"Webster County, Missouri(6,10)",73.9,30,"Webster County, Missouri",49,19,falling,37483,29,225,49,73.9
MO,"Worth County, Missouri",294,127,167,29227,45952,46131,NA,NA,NA,NA,859,147,906,110,1765,257,"Worth County, Missouri(6,10)",*,3 or fewer,"Worth County, Missouri",*,*,**,2057,29,227,NA,NA
MO,"Wright County, Missouri",4594,2173,2421,29229,29778,29153,NA,NA,NA,NA,7116,1859,7620,1657,14736,3516,"Wright County, Missouri(6,10)",83.4,21,"Wright County, Missouri",69.4,18,stable,18268,29,229,69.4,83.4
MO,"St. Louis city, Missouri",83416,37160,46256,29510,35599,50042,23155,33144,34193,34264,122966,27480,138200,24440,261166,51920,"St. Louis City, Missouri(6,10)",88.9,275,"St. Louis City, Missouri",66.2,204,falling,315685,29,510,66.2,88.9
MS,"Adams County, Mississippi",8898,3858,5040,28001,28869,41840,20921,NA,NA,47748,10865,3146,13122,2483,23987,5629,"Adams County, Mississippi(6,10)",69,29,"Adams County, Mississippi",60.6,26,stable,31254,28,1,60.6,69
MS,"Alcorn County, Mississippi",7752,3445,4307,28003,36163,37419,23045,NA,NA,41111,14442,3433,16119,2794,30561,6227,"Alcorn County, Mississippi(6,10)",75.7,37,"Alcorn County, Mississippi",59.9,29,stable,37388,28,3,59.9,75.7
MS,"Amite County, Mississippi",2852,1314,1538,28005,30704,35787,21829,NA,NA,NA,5265,1026,5465,971,10730,1997,"Amite County, Mississippi(6,10)",56.9,11,"Amite County, Mississippi",51.1,10,stable,12574,28,5,51.1,56.9
MS,"Attala County, Mississippi",4908,1796,3112,28007,32886,43036,21643,NA,NA,NA,7498,1341,8869,1160,16367,2501,"Attala County, Mississippi(6,10)",62.5,17,"Attala County, Mississippi",57.3,15,stable,19043,28,7,57.3,62.5
MS,"Benton County, Mississippi",1764,886,878,28009,33141,39628,24946,NA,NA,NA,3398,676,3619,696,7017,1372,"Benton County, Mississippi(6,10)",61.8,7,"Benton County, Mississippi",46.1,5,falling,8182,28,9,46.1,61.8
MS,"Bolivar County, Mississippi",11900,5142,6758,28011,27585,52659,20614,NA,NA,14746,11911,3314,15085,2666,26996,5980,"Bolivar County, Mississippi(6,10)",76.2,27,"Bolivar County, Mississippi",66.2,23,stable,33322,28,11,66.2,76.2
MS,"Calhoun County, Mississippi",3763,1682,2081,28013,31098,35525,22689,NA,NA,20500,5841,1212,6498,1086,12339,2298,"Calhoun County, Mississippi(6,10)",88.1,17,"Calhoun County, Mississippi",75.9,15,stable,14717,28,13,75.9,88.1
MS,"Carroll County, Mississippi",2086,839,1247,28015,37289,41287,24167,NA,NA,NA,4276,770,4524,580,8800,1350,"Carroll County, Mississippi(6,10)",72.3,11,"Carroll County, Mississippi",60.1,9,stable,10243,28,15,60.1,72.3
MS,"Chickasaw County, Mississippi",4493,1854,2639,28017,30926,36250,23902,NA,NA,57813,6650,1511,7634,1291,14284,2802,"Chickasaw County, Mississippi(6,10)",78.4,16,"Chickasaw County, Mississippi",63.7,13,stable,17328,28,17,63.7,78.4
MS,"Choctaw County, Mississippi",2147,862,1285,28019,30692,40731,17872,NA,NA,26250,3352,659,3784,459,7136,1118,"Choctaw County, Mississippi(6,10)",44.4,5,"Choctaw County, Mississippi",42.1,5,**,8299,28,19,42.1,44.4
MS,"Claiborne County, Mississippi",3685,1830,1855,28021,23259,51051,17500,NA,NA,20833,3398,910,4110,858,7508,1768,"Claiborne County, Mississippi(6,10)",93.3,10,"Claiborne County, Mississippi",53.9,6,stable,9150,28,21,53.9,93.3
MS,"Clarke County, Mississippi",3460,1429,2031,28023,35993,46437,22930,NA,NA,NA,6669,1016,7430,1191,14099,2207,"Clarke County, Mississippi(6,10)",75,17,"Clarke County, Mississippi",67.3,15,stable,16006,28,23,67.3,75
MS,"Clay County, Mississippi",5302,2240,3062,28025,31669,57193,20377,NA,NA,23333,7804,1453,9273,1464,17077,2917,"Clay County, Mississippi(6,10)",78.5,20,"Clay County, Mississippi",60.8,15,stable,20048,28,25,60.8,78.5
MS,"Coahoma County, Mississippi",8420,3418,5002,28027,28851,53536,21972,NA,35294,30958,9445,2065,11366,2085,20811,4150,"Coahoma County, Mississippi(6,10)",76.3,21,"Coahoma County, Mississippi",61.8,17,stable,24620,28,27,61.8,76.3
MS,"Copiah County, Mississippi",7629,3440,4189,28029,35130,45843,23882,NA,NA,NA,10959,2943,12458,2411,23417,5354,"Copiah County, Mississippi(6,10)",86.2,30,"Copiah County, Mississippi",59.5,20,stable,28773,28,29,59.5,86.2
MS,"Covington County, Mississippi",5162,2139,3023,28031,31631,36733,24375,NA,NA,35294,7549,1596,8578,1499,16127,3095,"Covington County, Mississippi(6,10)",78,19,"Covington County, Mississippi",44.8,11,falling,19543,28,31,44.8,78
MS,"DeSoto County, Mississippi",16338,6777,9561,28033,58278,61612,46600,NA,58281,41487,70131,11179,75876,10577,146007,21756,"DeSoto County, Mississippi(6,10)",78.4,118,"DeSoto County, Mississippi",58.5,85,falling,173323,28,33,58.5,78.4
MS,"Forrest County, Mississippi",20179,9239,10940,28035,36416,48568,22224,NA,NA,21113,28939,6894,33998,5750,62937,12644,"Forrest County, Mississippi(6,10)",84.2,61,"Forrest County, Mississippi",63.6,46,stable,75944,28,35,63.6,84.2
MS,"Franklin County, Mississippi",1464,703,761,28037,38170,45481,28241,NA,NA,NA,3170,621,3314,672,6484,1293,"Franklin County, Mississippi(6,10)",49.9,5,"Franklin County, Mississippi",35.2,4,**,7743,28,37,35.2,49.9
MS,"George County, Mississippi",4154,1784,2370,28039,44258,47404,27944,NA,NA,NA,9247,1973,9214,2200,18461,4173,"George County, Mississippi(6,10)",74.7,19,"George County, Mississippi",76.9,18,stable,23373,28,39,76.9,74.7
MS,"Greene County, Mississippi",1566,553,1013,28041,40176,43460,31094,NA,NA,NA,4221,945,4659,995,8880,1940,"Greene County, Mississippi(6,10)",46.1,7,"Greene County, Mississippi",45.9,7,stable,13522,28,41,45.9,46.1
MS,"Grenada County, Mississippi",4733,2254,2479,28043,31779,40365,21846,NA,NA,NA,8671,1336,9911,1348,18582,2684,"Grenada County, Mississippi(6,10)",93.4,25,"Grenada County, Mississippi",74.2,20,stable,21578,28,43,74.2,93.4
MS,"Hancock County, Mississippi",9807,4704,5103,28045,43355,45150,29918,NA,43618,49837,17172,5111,18887,4307,36059,9418,"Hancock County, Mississippi(6,10)",72.8,41,"Hancock County, Mississippi",49.8,28,falling,46420,28,45,49.8,72.8
MS,"Harrison County, Mississippi",39569,17498,22071,28047,41722,47544,26197,45588,45635,41217,72667,18692,79448,17720,152115,36412,"Harrison County, Mississippi(6,10)",89.5,179,"Harrison County, Mississippi",67.5,132,falling,201410,28,47,67.5,89.5
MS,"Hinds County, Mississippi",61498,26487,35011,28049,37324,56242,31541,18158,45900,27754,92795,20840,110849,18840,203644,39680,"Hinds County, Mississippi(6,10)",75.4,178,"Hinds County, Mississippi",46.4,110,stable,242891,28,49,46.4,75.4
MS,"Holmes County, Mississippi",7860,3472,4388,28051,20732,32260,18773,NA,NA,NA,7016,1885,8096,1636,15112,3521,"Holmes County, Mississippi(6,10)",95,19,"Holmes County, Mississippi",62.2,13,stable,18340,28,51,62.2,95
MS,"Humphreys County, Mississippi",3508,1539,1969,28053,23216,33958,19003,NA,NA,62679,3399,831,3738,929,7137,1760,"Humphreys County, Mississippi(6,10)",72.3,7,"Humphreys County, Mississippi",54.9,5,stable,8669,28,53,54.9,72.3
MS,"Issaquena County, Mississippi",411,234,177,28055,23491,32500,18333,NA,NA,NA,452,122,392,54,844,176,"Issaquena County, Mississippi(6,10)",*,3 or fewer,"Issaquena County, Mississippi",*,*,**,1337,28,55,NA,NA
MS,"Itawamba County, Mississippi",4207,2133,2074,28057,35004,35406,30726,NA,NA,73977,9983,1592,10393,1248,20376,2840,"Itawamba County, Mississippi(6,10)",95.6,28,"Itawamba County, Mississippi",68.9,20,stable,23609,28,57,68.9,95.6
MS,"Jackson County, Mississippi",21400,9488,11912,28059,48406,53190,31080,50978,61944,45348,56066,12275,59214,11759,115280,24034,"Jackson County, Mississippi(6,10)",75.8,116,"Jackson County, Mississippi",61.3,92,falling,141425,28,59,61.3,75.8
MS,"Jasper County, Mississippi",3944,1645,2299,28061,31578,40903,26858,NA,NA,NA,6799,1160,7498,1015,14297,2175,"Jasper County, Mississippi(6,10)",78.7,18,"Jasper County, Mississippi",52,12,stable,16569,28,61,52,78.7
MS,"Jefferson County, Mississippi",3490,1504,1986,28063,20743,52414,19124,NA,NA,NA,2776,509,3353,521,6129,1030,"Jefferson County, Mississippi(6,10)",77.7,7,"Jefferson County, Mississippi",59.7,5,stable,7507,28,63,59.7,77.7
MS,"Jefferson Davis County, Mississippi",4028,1624,2404,28065,26279,32228,22818,NA,NA,NA,4525,1117,4954,1234,9479,2351,"Jefferson Davis County, Mississippi(6,10)",68.6,12,"Jefferson Davis County, Mississippi",55,9,stable,11665,28,65,55,68.6
MS,"Jones County, Mississippi",15197,6073,9124,28067,37143,44334,21745,NA,123917,NA,28118,4544,29379,5481,57497,10025,"Jones County, Mississippi(6,10)",62.9,50,"Jones County, Mississippi",56,45,falling,68215,28,67,56,62.9
MS,"Kemper County, Mississippi",2841,1127,1714,28069,30056,37865,23277,20983,NA,NA,3883,763,4280,741,8163,1504,"Kemper County, Mississippi(6,10)",57,8,"Kemper County, Mississippi",48.3,7,stable,9969,28,69,48.3,57
MS,"Lafayette County, Mississippi",11903,5486,6417,28071,44643,47025,38281,NA,48846,18906,21278,3156,23650,2499,44928,5655,"Lafayette County, Mississippi(6,10)",63.6,28,"Lafayette County, Mississippi",50.6,21,falling,53154,28,71,50.6,63.6
MS,"Lamar County, Mississippi",9748,4503,5245,28073,52035,57894,34135,NA,51620,31278,23481,4500,25482,4475,48963,8975,"Lamar County, Mississippi(6,10)",62.7,33,"Lamar County, Mississippi",41.7,21,falling,60618,28,73,41.7,62.7
MS,"Lauderdale County, Mississippi",17325,6745,10580,28075,38132,51134,24369,NA,51154,68646,30735,5094,34787,5848,65522,10942,"Lauderdale County, Mississippi(6,10)",70.4,65,"Lauderdale County, Mississippi",53,49,falling,78524,28,75,53,70.4
MS,"Lawrence County, Mississippi",2769,1275,1494,28077,35634,42552,22025,NA,NA,NA,5157,1011,5309,1096,10466,2107,"Lawrence County, Mississippi(6,10)",106,17,"Lawrence County, Mississippi",76,12,stable,12622,28,77,76,106
MS,"Leake County, Mississippi",6034,2548,3486,28079,33452,37326,26563,53147,NA,33480,8559,2216,9134,2293,17693,4509,"Leake County, Mississippi(6,10)",75,20,"Leake County, Mississippi",73.6,19,rising,22763,28,79,73.6,75
MS,"Lee County, Mississippi",15327,6413,8914,28081,42784,50447,26571,NA,88407,40278,34316,5627,38624,5447,72940,11074,"Lee County, Mississippi(6,10)",91.3,83,"Lee County, Mississippi",84.5,77,rising,85300,28,81,84.5,91.3
MS,"Leflore County, Mississippi",12558,5473,7085,28083,24233,41980,17283,NA,77279,37740,11343,3248,13590,2675,24933,5923,"Leflore County, Mississippi(6,10)",82.3,26,"Leflore County, Mississippi",67.7,22,stable,30999,28,83,67.7,82.3
MS,"Lincoln County, Mississippi",9091,3751,5340,28085,36473,42102,22590,NA,NA,NA,13904,2489,14956,2823,28860,5312,"Lincoln County, Mississippi(6,10)",68.5,28,"Lincoln County, Mississippi",51.8,21,falling,34649,28,85,51.8,68.5
MS,"Lowndes County, Mississippi",13675,5540,8135,28087,40239,56538,22776,NA,NA,47375,22830,4314,25998,4761,48828,9075,"Lowndes County, Mississippi(6,10)",70.2,45,"Lowndes County, Mississippi",56.4,37,falling,59710,28,87,56.4,70.2
MS,"Madison County, Mississippi",13287,5430,7857,28089,64376,83939,41272,73043,83688,37083,42518,4619,47943,3948,90461,8567,"Madison County, Mississippi(6,10)",70.9,64,"Madison County, Mississippi",87.4,78,falling,103465,28,89,87.4,70.9
MS,"Marion County, Mississippi",7156,3313,3843,28091,30668,36550,21083,NA,NA,NA,10094,2173,10761,2325,20855,4498,"Marion County, Mississippi(6,10)",81.8,27,"Marion County, Mississippi",63.7,21,falling,25563,28,91,63.7,81.8
MS,"Marshall County, Mississippi",6513,2947,3566,28093,37419,42446,31437,NA,NA,45417,13625,3139,15270,3070,28895,6209,"Marshall County, Mississippi(6,10)",80.6,34,"Marshall County, Mississippi",70.1,29,stable,35916,28,93,70.1,80.6
MS,"Monroe County, Mississippi",7123,2940,4183,28095,36783,43892,27783,NA,NA,60106,14672,2389,16099,2600,30771,4989,"Monroe County, Mississippi(6,10)",81.6,38,"Monroe County, Mississippi",57.1,26,stable,35827,28,95,57.1,81.6
MS,"Montgomery County, Mississippi",3058,1215,1843,28097,30146,45660,19194,NA,NA,NA,4323,547,4879,598,9202,1145,"Montgomery County, Mississippi(6,10)",65.6,10,"Montgomery County, Mississippi",57,8,stable,10152,28,97,57,65.6
MS,"Neshoba County, Mississippi",6957,3071,3886,28099,35645,39169,26051,40372,NA,NA,11396,2592,12623,2524,24019,5116,"Neshoba County, Mississippi(6,10)",59.2,19,"Neshoba County, Mississippi",58.3,19,stable,29463,28,99,58.3,59.2
MS,"Newton County, Mississippi",4737,1955,2782,28101,37045,44917,26809,25329,NA,70766,8499,1583,9843,1548,18342,3131,"Newton County, Mississippi(6,10)",68.2,18,"Newton County, Mississippi",54.5,14,stable,21747,28,101,54.5,68.2
MS,"Noxubee County, Mississippi",3953,1771,2182,28103,26677,47692,18990,NA,NA,NA,4081,1140,4761,964,8842,2104,"Noxubee County, Mississippi(6,10)",57.8,8,"Noxubee County, Mississippi",52.2,7,stable,11043,28,103,52.2,57.8
MS,"Oktibbeha County, Mississippi",14780,7021,7759,28105,32485,41204,21856,56484,35304,32083,21214,3109,21499,2799,42713,5908,"Oktibbeha County, Mississippi(6,10)",51.9,20,"Oktibbeha County, Mississippi",42.9,16,stable,49800,28,105,42.9,51.9
MS,"Panola County, Mississippi",7793,3400,4393,28107,36555,47752,30316,NA,NA,24208,13551,2876,15501,2246,29052,5122,"Panola County, Mississippi(6,10)",75.2,29,"Panola County, Mississippi",73.8,28,stable,34167,28,107,73.8,75.2
MS,"Pearl River County, Mississippi",11590,4999,6591,28109,40976,42584,22280,NA,NA,43889,21467,5306,22456,5103,43923,10409,"Pearl River County, Mississippi(6,10)",89,60,"Pearl River County, Mississippi",70,47,stable,55191,28,109,70,89
MS,"Perry County, Mississippi",2287,865,1422,28111,34045,36845,25451,NA,NA,NA,4383,1495,5138,1067,9521,2562,"Perry County, Mississippi(6,10)",81.6,12,"Perry County, Mississippi",58.6,8,stable,12277,28,111,58.6,81.6
MS,"Pike County, Mississippi",11334,4633,6701,28113,31677,44447,23046,NA,71125,35921,15503,3132,17909,2925,33412,6057,"Pike County, Mississippi(6,10)",78.4,38,"Pike County, Mississippi",63.1,30,stable,39956,28,113,63.1,78.4
MS,"Pontotoc County, Mississippi",4903,2537,2366,28115,40645,41974,32869,NA,NA,38066,11979,3300,12552,2433,24531,5733,"Pontotoc County, Mississippi(6,10)",80.5,27,"Pontotoc County, Mississippi",60.4,20,stable,30908,28,115,60.4,80.5
MS,"Prentiss County, Mississippi",5112,2431,2681,28117,32945,36938,24400,NA,NA,NA,10214,2063,11030,1784,21244,3847,"Prentiss County, Mississippi(6,10)",82.4,26,"Prentiss County, Mississippi",78.2,24,stable,25459,28,117,78.2,82.4
MS,"Quitman County, Mississippi",2982,1280,1702,28119,24583,41580,19396,NA,NA,NA,2771,848,3192,776,5963,1624,"Quitman County, Mississippi(6,10)",75.1,7,"Quitman County, Mississippi",66.1,6,stable,7486,28,119,66.1,75.1
MS,"Rankin County, Mississippi",14067,5528,8539,28121,58801,62228,42906,40000,85043,49542,58718,8313,66576,7485,125294,15798,"Rankin County, Mississippi(6,10)",76.4,111,"Rankin County, Mississippi",46.9,67,falling,149039,28,121,46.9,76.4
MS,"Scott County, Mississippi",7743,3362,4381,28123,32935,43053,24994,NA,NA,31901,10538,2999,11649,2843,22187,5842,"Scott County, Mississippi(6,10)",87.3,27,"Scott County, Mississippi",64.3,19,stable,28265,28,123,64.3,87.3
MS,"Sharkey County, Mississippi",1380,607,773,28125,30525,60625,23946,NA,NA,49375,1542,565,2224,376,3766,941,"Sharkey County, Mississippi(6,10)",55.8,3,"Sharkey County, Mississippi",62.4,4,stable,4585,28,125,62.4,55.8
MS,"Simpson County, Mississippi",6985,3372,3613,28127,35375,40999,26273,NA,NA,32279,10553,2396,11369,2450,21922,4846,"Simpson County, Mississippi(6,10)",85.9,28,"Simpson County, Mississippi",60.5,20,stable,27222,28,127,60.5,85.9
MS,"Smith County, Mississippi",3813,1606,2207,28129,32951,39636,24442,NA,NA,NA,6684,1116,7253,1117,13937,2233,"Smith County, Mississippi(6,10)",61.9,13,"Smith County, Mississippi",65.8,14,stable,16059,28,129,65.8,61.9
MS,"Stone County, Mississippi",3103,1626,1477,28131,45025,50741,32097,NA,NA,NA,7048,1645,7318,1406,14366,3051,"Stone County, Mississippi(6,10)",82.2,16,"Stone County, Mississippi",71.8,13,stable,18070,28,131,71.8,82.2
MS,"Sunflower County, Mississippi",8458,3444,5014,28133,27384,48000,23418,NA,NA,NA,8412,2549,10925,2264,19337,4813,"Sunflower County, Mississippi(6,10)",65,18,"Sunflower County, Mississippi",59.8,17,stable,27005,28,133,59.8,65
MS,"Tallahatchie County, Mississippi",2609,881,1728,28135,29731,40991,25030,NA,NA,NA,3552,962,5273,726,8825,1688,"Tallahatchie County, Mississippi(6,10)",81.1,13,"Tallahatchie County, Mississippi",67.1,11,stable,14588,28,135,67.1,81.1
MS,"Tate County, Mississippi",4656,2196,2460,28137,42880,53820,28000,NA,NA,41230,11062,2487,12572,1817,23634,4304,"Tate County, Mississippi(6,10)",87.8,27,"Tate County, Mississippi",69.3,22,stable,28296,28,137,69.3,87.8
MS,"Tippah County, Mississippi",5311,2352,2959,28139,35609,37852,24429,NA,NA,NA,9246,1568,9666,1471,18912,3039,"Tippah County, Mississippi(6,10)",71.8,19,"Tippah County, Mississippi",52.8,14,stable,22131,28,139,52.8,71.8
MS,"Tishomingo County, Mississippi",3146,1342,1804,28141,35143,35861,19018,NA,223500,45110,7612,1654,8535,1478,16147,3132,"Tishomingo County, Mississippi(6,10)",78.4,22,"Tishomingo County, Mississippi",56.2,16,falling,19552,28,141,56.2,78.4
MS,"Tunica County, Mississippi",2824,999,1825,28143,31211,44634,28416,NA,NA,NA,3816,1036,4686,817,8502,1853,"Tunica County, Mississippi(6,10)",84.2,8,"Tunica County, Mississippi",56.6,5,falling,10343,28,143,56.6,84.2
MS,"Union County, Mississippi",6170,2262,3908,28145,35865,39277,25560,NA,NA,28101,10912,2427,11947,2257,22859,4684,"Union County, Mississippi(6,10)",72.4,23,"Union County, Mississippi",51.6,17,falling,28429,28,145,51.6,72.4
MS,"Walthall County, Mississippi",4199,1956,2243,28147,31384,45658,19375,NA,NA,NA,6014,1282,5852,1690,11866,2972,"Walthall County, Mississippi(6,10)",50.8,10,"Walthall County, Mississippi",57.4,11,stable,14638,28,147,57.4,50.8
MS,"Warren County, Mississippi",10768,4265,6503,28149,41121,57122,27481,NA,29459,NA,18641,3958,21323,3671,39964,7629,"Warren County, Mississippi(6,10)",73.7,41,"Warren County, Mississippi",56.8,31,stable,47485,28,149,56.8,73.7
MS,"Washington County, Mississippi",17586,7493,10093,28151,29144,47690,22243,2499,52361,NA,18157,4827,20778,5284,38935,10111,"Washington County, Mississippi(6,10)",75.8,42,"Washington County, Mississippi",63,34,stable,48130,28,151,63,75.8
MS,"Wayne County, Mississippi",5509,2334,3175,28153,32557,44435,19912,NA,NA,NA,8352,1605,8995,1494,17347,3099,"Wayne County, Mississippi(6,10)",61.2,15,"Wayne County, Mississippi",55.6,14,stable,20566,28,153,55.6,61.2
MS,"Webster County, Mississippi",2243,977,1266,28155,34448,43293,13239,NA,NA,NA,3951,922,4467,573,8418,1495,"Webster County, Mississippi(6,10)",90.6,12,"Webster County, Mississippi",76.6,10,stable,9899,28,155,76.6,90.6
MS,"Wilkinson County, Mississippi",2687,1182,1505,28157,29931,42143,21729,NA,NA,NA,3268,709,3551,812,6819,1521,"Wilkinson County, Mississippi(6,10)",60.5,7,"Wilkinson County, Mississippi",46.7,5,stable,9122,28,157,46.7,60.5
MS,"Winston County, Mississippi",5389,2222,3167,28159,33202,44525,22827,48750,NA,31875,7620,1061,8191,1373,15811,2434,"Winston County, Mississippi(6,10)",83.9,21,"Winston County, Mississippi",58.1,15,stable,18317,28,159,58.1,83.9
MS,"Yalobusha County, Mississippi",2472,1069,1403,28161,36502,40300,31236,NA,NA,NA,5011,965,5613,608,10624,1573,"Yalobusha County, Mississippi(6,10)",114.7,20,"Yalobusha County, Mississippi",78.4,14,rising,12447,28,161,78.4,114.7
MS,"Yazoo County, Mississippi",8017,3652,4365,28163,28961,42654,19796,NA,69500,13281,9419,2631,10493,1724,19912,4355,"Yazoo County, Mississippi(6,10)",95.3,27,"Yazoo County, Mississippi",59.6,17,stable,27387,28,163,59.6,95.3
MT,"Beaverhead County, Montana",1446,604,842,30001,41512,41149,NA,28875,48472,35556,4070,562,4035,490,8105,1052,"Beaverhead County, Montana(6,10)",52,7,"Beaverhead County, Montana",28.3,4,stable,9300,30,1,28.3,52
MT,"Big Horn County, Montana",3788,1737,2051,30003,41622,49451,NA,32231,NA,42688,3687,2775,4007,2551,7694,5326,"Big Horn County, Montana(6,10)",42.3,5,"Big Horn County, Montana",*,*,*,13242,30,3,NA,42.3
MT,"Blaine County, Montana",1795,839,956,30005,36744,43750,NA,26364,NA,60500,2153,1076,2308,971,4461,2047,"Blaine County, Montana(6,10)",76.8,6,"Blaine County, Montana",*,*,*,6577,30,5,NA,76.8
MT,"Broadwater County, Montana",556,257,299,30007,50115,49816,NA,NA,NA,NA,2445,434,2431,332,4876,766,"Broadwater County, Montana(6,10)",44.9,4,"Broadwater County, Montana",*,*,**,5689,30,7,NA,44.9
MT,"Carbon County, Montana",1137,505,632,30009,49767,49520,NA,53333,60536,NA,4396,704,4453,647,8849,1351,"Carbon County, Montana(6,10)",35.8,6,"Carbon County, Montana",21.3,4,falling,10408,30,9,21.3,35.8
MT,"Carter County, Montana",141,42,99,30011,45000,45000,NA,NA,NA,NA,497,116,459,134,956,250,"Carter County, Montana(6,10)",*,3 or fewer,"Carter County, Montana",*,*,**,1180,30,11,NA,NA
MT,"Cascade County, Montana",12212,5336,6876,30013,45205,46409,53194,19556,49438,37448,32558,5433,35087,5132,67645,10565,"Cascade County, Montana(6,10)",66.6,68,"Cascade County, Montana",50.3,51,stable,82278,30,13,50.3,66.6
MT,"Chouteau County, Montana",1341,610,731,30015,38521,42283,NA,20078,101250,NA,2242,661,2344,563,4586,1224,"Chouteau County, Montana(6,10)",59.1,5,"Chouteau County, Montana",*,*,**,5767,30,15,NA,59.1
MT,"Custer County, Montana",1298,566,732,30017,48750,50087,NA,NA,NA,NA,5149,672,5260,625,10409,1297,"Custer County, Montana(6,10)",70.8,11,"Custer County, Montana",48.9,9,stable,12135,30,17,48.9,70.8
MT,"Daniels County, Montana",100,30,70,30019,49239,49457,NA,NA,NA,NA,844,42,758,80,1602,122,"Daniels County, Montana(6,10)",*,3 or fewer,"Daniels County, Montana",*,*,**,1760,30,19,NA,NA
MT,"Dawson County, Montana",1210,741,469,30021,52738,55830,NA,31318,NA,16469,4065,605,3919,437,7984,1042,"Dawson County, Montana(6,10)",84.6,11,"Dawson County, Montana",49.4,6,stable,9625,30,21,49.4,84.6
MT,"Deer Lodge County, Montana",1499,739,760,30023,39399,39151,NA,40536,NA,NA,3834,745,3656,487,7490,1232,"Deer Lodge County, Montana(6,10)",59.5,9,"Deer Lodge County, Montana",53.1,8,falling,9139,30,23,53.1,59.5
MT,"Fallon County, Montana",198,60,138,30025,53266,53548,NA,NA,NA,NA,1353,196,1304,167,2657,363,"Fallon County, Montana(6,10)",*,3 or fewer,"Fallon County, Montana",*,*,**,3190,30,25,NA,NA
MT,"Fergus County, Montana",1287,592,695,30027,40881,41594,NA,NA,NA,2499,4763,888,4876,721,9639,1609,"Fergus County, Montana(6,10)",58.5,12,"Fergus County, Montana",50.5,10,stable,11427,30,27,50.5,58.5
MT,"Flathead County, Montana",12307,5818,6489,30029,47851,48161,80284,34390,NA,44219,38210,8056,39283,7180,77493,15236,"Flathead County, Montana(6,10)",58.4,65,"Flathead County, Montana",33.4,38,falling,96165,30,29,33.4,58.4
MT,"Gallatin County, Montana",12125,6297,5828,30031,55553,56415,NA,31548,57308,37500,42674,6272,41109,4917,83783,11189,"Gallatin County, Montana(6,10)",37.1,29,"Gallatin County, Montana",27.8,21,stable,100739,30,31,27.8,37.1
MT,"Garfield County, Montana",96,54,42,30033,39732,42083,NA,NA,NA,NA,405,93,441,108,846,201,"Garfield County, Montana(6,10)",*,3 or fewer,"Garfield County, Montana",*,*,**,1314,30,33,NA,NA
MT,"Glacier County, Montana",4447,1962,2485,30035,29640,40585,NA,25000,32031,NA,4047,2542,4625,2325,8672,4867,"Glacier County, Montana(6,10)",92.4,11,"Glacier County, Montana",62.5,7,stable,13647,30,35,62.5,92.4
MT,"Golden Valley County, Montana",201,91,110,30037,40938,41250,NA,NA,NA,NA,322,42,299,93,621,135,"Golden Valley County, Montana(6,10)",*,3 or fewer,"Golden Valley County, Montana",*,*,**,827,30,37,NA,NA
MT,"Granite County, Montana",466,218,248,30039,48512,48214,NA,NA,NA,NA,1395,221,1301,225,2696,446,"Granite County, Montana(6,10)",*,3 or fewer,"Granite County, Montana",*,*,**,3240,30,39,NA,NA
MT,"Hill County, Montana",3400,1581,1819,30041,44633,48011,NA,34474,NA,NA,7002,1317,6551,1519,13553,2836,"Hill County, Montana(6,10)",64.4,11,"Hill County, Montana",33.2,6,falling,16572,30,41,33.2,64.4
MT,"Jefferson County, Montana",1068,531,537,30043,60842,61068,NA,NA,NA,82833,5373,511,4850,599,10223,1110,"Jefferson County, Montana(6,10)",71.9,11,"Jefferson County, Montana",50.1,7,**,11645,30,43,50.1,71.9
MT,"Judith Basin County, Montana",281,141,140,30045,44602,44943,NA,NA,NA,NA,932,109,775,181,1707,290,"Judith Basin County, Montana(6,10)",*,3 or fewer,"Judith Basin County, Montana",*,*,**,1926,30,45,NA,NA
MT,"Lake County, Montana",6509,3171,3338,30047,38732,40828,NA,31419,NA,38346,10614,3612,11416,3344,22030,6956,"Lake County, Montana(6,10)",52.6,21,"Lake County, Montana",37.4,15,falling,29457,30,47,37.4,52.6
MT,"Lewis and Clark County, Montana",7803,3651,4152,30049,56197,57445,51736,30326,55083,31607,28620,3455,29722,2920,58342,6375,"Lewis and Clark County, Montana(6,10)",65.2,49,"Lewis and Clark County, Montana",45.4,34,stable,66418,30,49,45.4,65.2
MT,"Liberty County, Montana",416,174,242,30051,47768,47768,NA,NA,NA,NA,987,169,1036,155,2023,324,"Liberty County, Montana(6,10)",*,3 or fewer,"Liberty County, Montana",*,*,**,2408,30,51,NA,NA
MT,"Lincoln County, Montana",3554,1627,1927,30053,35275,35022,NA,13646,NA,41250,7780,1879,7663,1845,15443,3724,"Lincoln County, Montana(6,10)",71.4,24,"Lincoln County, Montana",56.8,18,stable,19052,30,53,56.8,71.4
MT,"McCone County, Montana",151,78,73,30055,40750,40750,NA,NA,NA,NA,835,84,748,39,1583,123,"McCone County, Montana(6,10)",*,3 or fewer,"McCone County, Montana",*,*,**,1683,30,55,NA,NA
MT,"Madison County, Montana",820,408,412,30057,46250,46552,NA,NA,NA,NA,3376,685,3131,515,6507,1200,"Madison County, Montana(6,10)",44.9,6,"Madison County, Montana",31.3,4,**,7915,30,57,31.3,44.9
MT,"Meagher County, Montana",265,77,188,30059,41641,42083,NA,40313,NA,NA,737,150,826,160,1563,310,"Meagher County, Montana(6,10)",97.1,3,"Meagher County, Montana",*,*,**,1830,30,59,NA,97.1
MT,"Mineral County, Montana",721,331,390,30061,36031,35906,NA,NA,45750,NA,1591,509,1767,319,3358,828,"Mineral County, Montana(6,10)",66.4,5,"Mineral County, Montana",56.9,4,**,4251,30,61,56.9,66.4
MT,"Missoula County, Montana",17414,8279,9135,30063,46164,47284,21406,31417,50425,32557,46957,8965,48368,7019,95325,15984,"Missoula County, Montana(6,10)",56.9,61,"Missoula County, Montana",42,45,falling,114181,30,63,42,56.9
MT,"Musselshell County, Montana",774,324,450,30065,39517,39929,NA,NA,NA,95875,2075,297,2021,363,4096,660,"Musselshell County, Montana(6,10)",82,6,"Musselshell County, Montana",66.6,5,**,4582,30,65,66.6,82
MT,"Park County, Montana",1918,828,1090,30067,43932,44585,NA,NA,NA,46000,6335,1508,6846,929,13181,2437,"Park County, Montana(6,10)",42.8,9,"Park County, Montana",22.8,5,falling,15972,30,67,22.8,42.8
MT,"Petroleum County, Montana",30,12,18,30069,43750,43750,NA,NA,NA,NA,169,63,147,64,316,127,"Petroleum County, Montana(6,10)",*,3 or fewer,"Petroleum County, Montana",*,*,**,475,30,69,NA,NA
MT,"Phillips County, Montana",651,274,377,30071,36071,34603,NA,39479,NA,32961,1612,466,1678,371,3290,837,"Phillips County, Montana(6,10)",53.2,4,"Phillips County, Montana",54.2,4,stable,4169,30,71,54.2,53.2
MT,"Pondera County, Montana",1283,676,607,30073,42264,46944,NA,25893,107917,NA,2449,589,2625,471,5074,1060,"Pondera County, Montana(6,10)",66.3,6,"Pondera County, Montana",40.4,3,stable,6184,30,73,40.4,66.3
MT,"Powder River County, Montana",155,71,84,30075,46346,44722,NA,71250,NA,81250,709,118,696,147,1405,265,"Powder River County, Montana(6,10)",*,3 or fewer,"Powder River County, Montana",*,*,**,1773,30,75,NA,NA
MT,"Powell County, Montana",735,319,416,30077,40000,40288,NA,NA,NA,NA,2370,414,2215,372,4585,786,"Powell County, Montana(6,10)",85.3,8,"Powell County, Montana",44,4,stable,6840,30,77,44,85.3
MT,"Prairie County, Montana",239,113,126,30079,42383,44688,NA,NA,NA,NA,608,118,571,56,1179,174,"Prairie County, Montana(6,10)",*,3 or fewer,"Prairie County, Montana",*,*,**,1160,30,79,NA,NA
MT,"Ravalli County, Montana",7308,3338,3970,30081,39480,39869,NA,17059,NA,42500,16273,3831,17080,3386,33353,7217,"Ravalli County, Montana(6,10)",48.9,31,"Ravalli County, Montana",33,21,falling,41373,30,81,33,48.9
MT,"Richland County, Montana",1264,547,717,30083,65084,65560,NA,72321,NA,48382,4632,1067,4405,1028,9037,2095,"Richland County, Montana(6,10)",78.6,10,"Richland County, Montana",43.1,5,stable,11960,30,83,43.1,78.6
MT,"Roosevelt County, Montana",3007,1383,1624,30085,32974,50387,NA,22018,124375,NA,3768,1672,4041,1373,7809,3045,"Roosevelt County, Montana(6,10)",64.2,6,"Roosevelt County, Montana",33.7,3,stable,11476,30,85,33.7,64.2
MT,"Rosebud County, Montana",1893,826,1067,30087,51159,60208,NA,26121,NA,55391,3493,1025,3560,1191,7053,2216,"Rosebud County, Montana(6,10)",56.8,5,"Rosebud County, Montana",39.5,3,stable,9398,30,87,39.5,56.8
MT,"Sanders County, Montana",2497,1104,1393,30089,32257,32350,NA,21875,NA,NA,4653,1092,4124,1341,8777,2433,"Sanders County, Montana(6,10)",62.1,13,"Sanders County, Montana",45.4,9,falling,11336,30,89,45.4,62.1
MT,"Sheridan County, Montana",373,165,208,30091,50664,54511,NA,9375,NA,NA,1621,193,1650,112,3271,305,"Sheridan County, Montana(6,10)",68,5,"Sheridan County, Montana",59.7,4,**,3687,30,91,59.7,68
MT,"Silver Bow County, Montana",6771,3228,3543,30093,37749,37301,NA,45840,NA,36076,14473,2808,14162,2516,28635,5324,"Silver Bow County, Montana(6,10)",56,25,"Silver Bow County, Montana",44,20,stable,34622,30,93,44,56
MT,"Stillwater County, Montana",721,312,409,30095,58259,57737,NA,NA,NA,70273,4172,507,4038,512,8210,1019,"Stillwater County, Montana(6,10)",49.2,7,"Stillwater County, Montana",29.7,4,**,9486,30,95,29.7,49.2
MT,"Sweet Grass County, Montana",458,203,255,30097,50588,50221,NA,NA,NA,31667,1534,226,1665,177,3199,403,"Sweet Grass County, Montana(6,10)",70.2,4,"Sweet Grass County, Montana",59.3,4,**,3634,30,97,59.3,70.2
MT,"Teton County, Montana",723,348,375,30099,46360,47442,NA,23382,NA,34792,2544,442,2580,439,5124,881,"Teton County, Montana(6,10)",60.8,6,"Teton County, Montana",55.7,5,stable,6104,30,99,55.7,60.8
MT,"Toole County, Montana",866,341,525,30101,44804,45868,NA,NA,NA,NA,1838,518,1732,454,3570,972,"Toole County, Montana(6,10)",77.5,5,"Toole County, Montana",48.7,3,**,5087,30,101,48.7,77.5
MT,"Treasure County, Montana",178,104,74,30103,41103,41765,NA,NA,NA,23906,388,44,347,33,735,77,"Treasure County, Montana(6,10)",*,3 or fewer,"Treasure County, Montana",*,*,**,697,30,103,NA,NA
MT,"Valley County, Montana",885,432,453,30105,49141,50913,NA,40076,NA,26379,3234,523,3301,409,6535,932,"Valley County, Montana(6,10)",48.8,6,"Valley County, Montana",*,*,**,7659,30,105,NA,48.8
MT,"Wheatland County, Montana",410,194,216,30107,32723,32656,NA,NA,NA,37500,885,184,868,145,1753,329,"Wheatland County, Montana(6,10)",*,3 or fewer,"Wheatland County, Montana",*,*,**,2110,30,107,NA,NA
MT,"Wibaux County, Montana",145,54,91,30109,38553,38553,NA,NA,NA,NA,403,73,410,76,813,149,"Wibaux County, Montana(6,10)",*,3 or fewer,"Wibaux County, Montana",*,*,**,1130,30,109,NA,NA
MT,"Yellowstone County, Montana",17250,7477,9773,30111,52802,54237,27996,31414,71225,32251,63566,10886,66659,10258,130225,21144,"Yellowstone County, Montana(6,10)",60.9,105,"Yellowstone County, Montana",45,79,falling,157048,30,111,45,60.9
NC,"Alamance County, North Carolina",29042,13130,15912,37001,41814,46497,31451,22167,60982,31018,61793,11848,68721,11831,130514,23679,"Alamance County, North Carolina(6,10)",71.3,131,"Alamance County, North Carolina",51.8,95,falling,158276,37,1,51.8,71.3
NC,"Alexander County, North Carolina",6191,3003,3188,37003,39365,39393,44750,NA,63750,34338,15713,2301,16031,1981,31744,4282,"Alexander County, North Carolina(6,10)",75.7,36,"Alexander County, North Carolina",51.1,24,stable,37325,37,3,51.1,75.7
NC,"Alleghany County, North Carolina",1986,852,1134,37005,36968,38681,NA,53276,NA,18059,4369,1002,4481,931,8850,1933,"Alleghany County, North Carolina(6,10)",62.4,12,"Alleghany County, North Carolina",59.3,11,stable,10837,37,5,59.3,62.4
NC,"Anson County, North Carolina",5865,2550,3315,37007,33228,43388,25400,NA,32000,29211,9707,2339,10387,1918,20094,4257,"Anson County, North Carolina(6,10)",80.5,26,"Anson County, North Carolina",56.3,18,stable,25759,37,7,56.3,80.5
NC,"Ashe County, North Carolina",5510,2737,2773,37009,36267,36623,13750,NA,NA,21836,10685,2605,11580,1983,22265,4588,"Ashe County, North Carolina(6,10)",70.1,30,"Ashe County, North Carolina",52.1,22,stable,27020,37,9,52.1,70.1
NC,"Avery County, North Carolina",2350,1240,1110,37011,37777,38525,NA,NA,NA,20139,6224,1573,6565,1376,12789,2949,"Avery County, North Carolina(6,10)",65.5,17,"Avery County, North Carolina",49,13,stable,17689,37,11,49,65.5
NC,"Beaufort County, North Carolina",8660,3746,4914,37013,40391,46998,25176,NA,NA,26533,19022,3482,21646,3048,40668,6530,"Beaufort County, North Carolina(6,10)",83.5,58,"Beaufort County, North Carolina",59.1,41,falling,47651,37,13,59.1,83.5
NC,"Bertie County, North Carolina",4304,2038,2266,37015,30027,44634,24440,60500,45625,30880,7722,1578,8666,1315,16388,2893,"Bertie County, North Carolina(6,10)",69.7,20,"Bertie County, North Carolina",49.4,14,falling,20199,37,15,49.4,69.7
NC,"Bladen County, North Carolina",9342,4175,5167,37017,30096,40610,21756,22566,NA,13520,13489,2722,15516,2571,29005,5293,"Bladen County, North Carolina(6,10)",64.1,30,"Bladen County, North Carolina",51.1,25,stable,34318,37,17,51.1,64.1
NC,"Brunswick County, North Carolina",18725,8143,10582,37019,46859,49770,29439,26940,71154,41891,46541,9270,51200,7963,97741,17233,"Brunswick County, North Carolina(6,10)",69.8,127,"Brunswick County, North Carolina",56.8,101,falling,122765,37,19,56.8,69.8
NC,"Buncombe County, North Carolina",38256,17640,20616,37021,45167,46805,26065,59263,51780,26533,97521,19497,109819,16677,207340,36174,"Buncombe County, North Carolina(6,10)",66.2,211,"Buncombe County, North Carolina",47,150,falling,253178,37,21,47,66.2
NC,"Burke County, North Carolina",17277,7762,9515,37023,39360,41010,26906,55096,44107,21283,35628,7025,38742,5727,74370,12752,"Burke County, North Carolina(6,10)",83.1,100,"Burke County, North Carolina",61,73,stable,88842,37,23,61,83.1
NC,"Cabarrus County, North Carolina",23384,10512,12872,37025,54720,59540,41394,53250,112269,38015,78787,12302,84177,11749,162964,24051,"Cabarrus County, North Carolina(6,10)",76.9,135,"Cabarrus County, North Carolina",53.1,92,stable,196762,37,25,53.1,76.9
NC,"Caldwell County, North Carolina",15765,6956,8809,37027,35763,36386,20147,41250,66429,28806,32631,6954,35162,6149,67793,13103,"Caldwell County, North Carolina(6,10)",82.9,89,"Caldwell County, North Carolina",69.1,73,stable,81287,37,27,69.1,82.9
NC,"Camden County, North Carolina",803,370,433,37029,58780,61602,50125,NA,34886,NA,4459,488,4608,432,9067,920,"Camden County, North Carolina(6,10)",41.1,5,"Camden County, North Carolina",25.4,3,falling,10309,37,29,25.4,41.1
NC,"Carteret County, North Carolina",10056,4547,5509,37031,48457,50119,24883,53125,58333,30721,26963,5127,29397,4961,56360,10088,"Carteret County, North Carolina(6,10)",76.1,77,"Carteret County, North Carolina",62.9,63,falling,68879,37,31,62.9,76.1
NC,"Caswell County, North Carolina",4634,2029,2605,37033,37869,40880,31483,NA,NA,22228,9255,1611,9896,1485,19151,3096,"Caswell County, North Carolina(6,10)",70.4,22,"Caswell County, North Carolina",50.2,16,stable,22941,37,33,50.2,70.4
NC,"Catawba County, North Carolina",23629,10699,12930,37035,44376,47561,27516,60769,47188,27429,63444,11588,68560,9556,132004,21144,"Catawba County, North Carolina(6,10)",68.8,126,"Catawba County, North Carolina",54,99,falling,155056,37,35,54,68.8
NC,"Chatham County, North Carolina",9041,4550,4491,37037,56642,61378,29673,NA,NA,31062,27262,5354,30028,4042,57290,9396,"Chatham County, North Carolina(6,10)",53,52,"Chatham County, North Carolina",38.5,39,stable,70928,37,37,38.5,53
NC,"Cherokee County, North Carolina",5319,2403,2916,37039,34662,34692,12989,21528,48684,NA,10488,2637,11249,2436,21737,5073,"Cherokee County, North Carolina(6,10)",79.1,39,"Cherokee County, North Carolina",57.2,28,stable,27178,37,39,57.2,79.1
NC,"Chowan County, North Carolina",3832,1747,2085,37041,38759,48095,20970,NA,NA,NA,5740,1163,6529,956,12269,2119,"Chowan County, North Carolina(6,10)",66.1,15,"Chowan County, North Carolina",59.2,14,stable,14394,37,41,59.2,66.1
NC,"Clay County, North Carolina",2235,1007,1228,37043,37076,37388,NA,NA,NA,24637,4078,994,4521,1002,8599,1996,"Clay County, North Carolina(6,10)",69.3,14,"Clay County, North Carolina",50.3,10,stable,10703,37,43,50.3,69.3
NC,"Cleveland County, North Carolina",19156,8012,11144,37045,39453,43965,24832,NA,105598,40729,38871,7516,43812,6666,82683,14182,"Cleveland County, North Carolina(6,10)",72.3,90,"Cleveland County, North Carolina",59.2,73,stable,96879,37,45,59.2,72.3
NC,"Columbus County, North Carolina",12768,5572,7196,37047,34949,41415,23478,39103,NA,31616,20690,5109,24204,4529,44894,9638,"Columbus County, North Carolina(6,10)",82.6,61,"Columbus County, North Carolina",63.6,46,stable,56694,37,47,63.6,82.6
NC,"Craven County, North Carolina",15664,6578,9086,37049,47985,54139,30249,38730,39189,38498,38039,7825,44473,6620,82512,14445,"Craven County, North Carolina(6,10)",81,103,"Craven County, North Carolina",57,73,stable,103451,37,49,57,81
NC,"Cumberland County, North Carolina",54949,22453,32496,37051,44171,50065,36925,34352,48420,38158,115293,19292,143351,18868,258644,38160,"Cumberland County, North Carolina(6,10)",73.3,202,"Cumberland County, North Carolina",56.6,154,falling,323838,37,51,56.6,73.3
NC,"Currituck County, North Carolina",2497,1018,1479,37053,60600,61576,55625,56373,NA,26900,9858,2142,10360,1831,20218,3973,"Currituck County, North Carolina(6,10)",78.6,22,"Currituck County, North Carolina",70.8,18,stable,25263,37,53,70.8,78.6
NC,"Dare County, North Carolina",2885,1204,1681,37055,54496,55418,33500,28199,NA,38369,13604,3436,14946,2720,28550,6156,"Dare County, North Carolina(6,10)",66.3,31,"Dare County, North Carolina",41.8,18,falling,35663,37,55,41.8,66.3
NC,"Davidson County, North Carolina",25655,11254,14401,37057,43363,45868,30735,48750,78474,36238,67953,11300,72487,10369,140440,21669,"Davidson County, North Carolina(6,10)",83.9,170,"Davidson County, North Carolina",61.3,122,stable,164622,37,57,61.3,83.9
NC,"Davie County, North Carolina",5210,2384,2826,37059,51527,53615,35945,NA,NA,53086,17033,2985,18774,2265,35807,5250,"Davie County, North Carolina(6,10)",81.6,47,"Davie County, North Carolina",48.3,27,stable,41753,37,59,48.3,81.6
NC,"Duplin County, North Carolina",15606,7197,8409,37061,35035,41124,25208,NA,48669,29642,21885,6997,24085,5858,45970,12855,"Duplin County, North Carolina(6,10)",62,45,"Duplin County, North Carolina",48,34,falling,59159,37,61,48,62
NC,"Durham County, North Carolina",49835,23570,26265,37063,52503,63510,39332,43942,61706,39025,110556,23537,130140,19125,240696,42662,"Durham County, North Carolina(6,10)",61.1,147,"Durham County, North Carolina",46.6,110,falling,300952,37,63,46.6,61.1
NC,"Edgecombe County, North Carolina",14210,6021,8189,37065,32659,40699,28421,NA,NA,27413,20437,4951,24507,4335,44944,9286,"Edgecombe County, North Carolina(6,10)",65.8,47,"Edgecombe County, North Carolina",53.5,38,falling,54150,37,65,53.5,65.8
NC,"Forsyth County, North Carolina",69100,30558,38542,37067,45471,53046,29527,29911,72790,28590,142855,27087,164825,23837,307680,50924,"Forsyth County, North Carolina(6,10)",70.9,277,"Forsyth County, North Carolina",52.9,206,falling,369019,37,67,52.9,70.9
NC,"Franklin County, North Carolina",9603,4247,5356,37069,42685,50847,27624,39175,NA,35335,25114,5007,26451,4666,51565,9673,"Franklin County, North Carolina(6,10)",76.3,53,"Franklin County, North Carolina",58.9,40,stable,63710,37,69,58.9,76.3
NC,"Gaston County, North Carolina",36027,15570,20457,37071,42429,45474,31668,37829,73929,30537,83675,16824,91558,15628,175233,32452,"Gaston County, North Carolina(6,10)",87.2,211,"Gaston County, North Carolina",63.1,150,falling,213442,37,71,63.1,87.2
NC,"Gates County, North Carolina",1651,683,968,37073,49258,51986,39180,NA,NA,35670,5023,707,5360,536,10383,1243,"Gates County, North Carolina(6,10)",51.8,8,"Gates County, North Carolina",56,9,stable,11431,37,73,56,51.8
NC,"Graham County, North Carolina",1884,867,1017,37075,34805,35828,NA,22400,NA,35268,3237,970,3518,861,6755,1831,"Graham County, North Carolina(6,10)",48.8,7,"Graham County, North Carolina",35.3,5,falling,8616,37,75,35.3,48.8
NC,"Granville County, North Carolina",8943,4172,4771,37077,50225,56272,33947,64063,113068,50968,22929,3950,25312,2850,48241,6800,"Granville County, North Carolina(6,10)",82.3,56,"Granville County, North Carolina",52.5,35,stable,58674,37,77,52.5,82.3
NC,"Greene County, North Carolina",4962,2049,2913,37079,35777,40677,32725,NA,NA,23710,7809,1790,8255,1427,16064,3217,"Greene County, North Carolina(6,10)",70.2,17,"Greene County, North Carolina",56.9,13,stable,21134,37,79,56.9,70.2
NC,"Guilford County, North Carolina",86808,37328,49480,37081,45651,56719,33980,47361,48382,32192,200451,37996,230196,34220,430647,72216,"Guilford County, North Carolina(6,10)",70.3,367,"Guilford County, North Carolina",48.3,251,falling,517600,37,81,48.3,70.3
NC,"Halifax County, North Carolina",13660,6086,7574,37083,32245,45254,23531,23125,53889,53897,20409,4057,24473,3054,44882,7111,"Halifax County, North Carolina(6,10)",68.9,51,"Halifax County, North Carolina",52.4,39,stable,52456,37,83,52.4,68.9
NC,"Harnett County, North Carolina",22094,9986,12108,37085,46353,51068,34185,38200,92344,35349,47081,8855,53827,8332,100908,17187,"Harnett County, North Carolina(6,10)",86.3,93,"Harnett County, North Carolina",60.2,63,stable,128140,37,85,60.2,86.3
NC,"Haywood County, North Carolina",10056,4642,5414,37087,42257,42510,27431,NA,NA,41354,23777,4670,26178,4045,49955,8715,"Haywood County, North Carolina(6,10)",70.2,67,"Haywood County, North Carolina",47.7,46,stable,59868,37,87,47.7,70.2
NC,"Henderson County, North Carolina",14984,7217,7767,37089,46448,47247,23319,61362,60795,26973,43911,8840,48683,7206,92594,16046,"Henderson County, North Carolina(6,10)",59.9,109,"Henderson County, North Carolina",43.5,80,falling,112655,37,89,43.5,59.9
NC,"Hertford County, North Carolina",5475,2134,3341,37091,33008,42870,25381,24063,71389,NA,8458,1524,10779,1411,19237,2935,"Hertford County, North Carolina(6,10)",68.3,22,"Hertford County, North Carolina",48.4,16,falling,24184,37,91,48.4,68.3
NC,"Hoke County, North Carolina",11047,4612,6435,37093,41542,55712,34740,29688,NA,37113,18294,3161,21943,3481,40237,6642,"Hoke County, North Carolina(6,10)",96.9,34,"Hoke County, North Carolina",75.3,24,stable,52671,37,93,75.3,96.9
NC,"Hyde County, North Carolina",890,278,612,37095,42897,53348,33958,NA,NA,NA,1997,458,2152,420,4149,878,"Hyde County, North Carolina(6,10)",83.6,6,"Hyde County, North Carolina",54.9,4,**,5526,37,95,54.9,83.6
NC,"Iredell County, North Carolina",22803,9533,13270,37097,52306,55471,31184,62045,86094,34778,69972,10617,72976,10314,142948,20931,"Iredell County, North Carolina(6,10)",73.9,131,"Iredell County, North Carolina",52.2,92,falling,169866,37,97,52.2,73.9
NC,"Jackson County, North Carolina",8139,3911,4228,37099,38015,39363,22692,31806,NA,18239,16388,3487,17794,2816,34182,6303,"Jackson County, North Carolina(6,10)",64.9,33,"Jackson County, North Carolina",50.1,25,stable,41265,37,99,50.1,64.9
NC,"Johnston County, North Carolina",27086,12599,14487,37101,50512,54415,39871,18628,38304,30948,72358,14182,77916,12270,150274,26452,"Johnston County, North Carolina(6,10)",70.1,116,"Johnston County, North Carolina",58.4,94,falling,185660,37,101,58.4,70.1
NC,"Jones County, North Carolina",2173,889,1284,37103,34005,43750,23341,35536,NA,50147,3862,1023,4482,696,8344,1719,"Jones County, North Carolina(6,10)",86.4,13,"Jones County, North Carolina",65.9,10,stable,10013,37,103,65.9,86.4
NC,"Lee County, North Carolina",10533,4363,6170,37105,45608,51879,30547,44306,69844,33104,22501,5700,24947,5037,47448,10737,"Lee County, North Carolina(6,10)",76.6,51,"Lee County, North Carolina",54.7,36,falling,59660,37,105,54.7,76.6
NC,"Lenoir County, North Carolina",13401,5724,7677,37107,34717,41064,26813,79792,46780,26283,21830,5509,26143,4306,47973,9815,"Lenoir County, North Carolina(6,10)",73,57,"Lenoir County, North Carolina",53.2,42,falling,58106,37,107,53.2,73
NC,"Lincoln County, North Carolina",12243,5509,6734,37109,49215,51369,31250,35380,NA,41000,33425,5657,34528,5400,67953,11057,"Lincoln County, North Carolina(6,10)",71.6,65,"Lincoln County, North Carolina",51.8,47,stable,81035,37,109,51.8,71.6
NC,"McDowell County, North Carolina",8897,4138,4759,37111,35965,37085,20744,NA,54545,36324,18526,3360,19508,2625,38034,5985,"McDowell County, North Carolina(6,10)",88.6,54,"McDowell County, North Carolina",58.1,35,stable,44989,37,111,58.1,88.6
NC,"Macon County, North Carolina",6401,2951,3450,37113,39133,39966,NA,65536,52917,30705,13028,3366,14225,3072,27253,6438,"Macon County, North Carolina(6,10)",75.4,46,"Macon County, North Carolina",57.9,35,stable,34201,37,113,57.9,75.4
NC,"Madison County, North Carolina",3616,1490,2126,37115,37904,38289,NA,NA,NA,NA,8835,1533,9401,1025,18236,2558,"Madison County, North Carolina(6,10)",56.5,18,"Madison County, North Carolina",47,14,falling,21139,37,115,47,56.5
NC,"Martin County, North Carolina",5007,2191,2816,37117,35080,46131,27717,NA,NA,27118,9207,1912,10402,2070,19609,3982,"Martin County, North Carolina(6,10)",68,24,"Martin County, North Carolina",47.2,16,falling,23357,37,117,47.2,68
NC,"Mecklenburg County, North Carolina",148326,65072,83254,37119,56854,71296,39159,43292,71071,39397,394554,79148,440912,70014,835466,149162,"Mecklenburg County, North Carolina(6,10)",59.4,452,"Mecklenburg County, North Carolina",41.9,314,falling,1034070,37,119,41.9,59.4
NC,"Mitchell County, North Carolina",2910,1265,1645,37121,37391,37558,NA,NA,NA,23295,6327,1139,6653,1084,12980,2223,"Mitchell County, North Carolina(6,10)",81.4,20,"Mitchell County, North Carolina",63.3,16,stable,15246,37,121,63.3,81.4
NC,"Montgomery County, North Carolina",6716,2942,3774,37123,32500,37939,21250,30542,56921,30689,10297,2606,11294,2567,21591,5173,"Montgomery County, North Carolina(6,10)",71.3,26,"Montgomery County, North Carolina",49.4,18,falling,27548,37,123,49.4,71.3
NC,"Moore County, North Carolina",13808,5800,8008,37125,50998,55347,25659,75625,73421,33080,37266,5229,41237,5632,78503,10861,"Moore County, North Carolina(6,10)",73.7,108,"Moore County, North Carolina",48.5,74,stable,94352,37,125,48.5,73.7
NC,"Nash County, North Carolina",17141,7079,10062,37127,42713,51941,31232,37344,38750,34853,37616,6774,41977,6855,79593,13629,"Nash County, North Carolina(6,10)",72.8,85,"Nash County, North Carolina",58,68,stable,93919,37,127,58,72.8
NC,"New Hanover County, North Carolina",36717,15886,20831,37129,50088,54244,29279,56136,77176,32443,84864,16254,96287,13171,181151,29425,"New Hanover County, North Carolina(6,10)",66.2,158,"New Hanover County, North Carolina",48.7,115,falling,220358,37,129,48.7,66.2
NC,"Northampton County, North Carolina",5658,2269,3389,37131,30429,44398,22484,11944,NA,27813,7822,1734,9211,1484,17033,3218,"Northampton County, North Carolina(6,10)",72.4,24,"Northampton County, North Carolina",56.8,19,stable,20426,37,131,56.8,72.4
NC,"Onslow County, North Carolina",24916,10709,14207,37133,46335,48660,36334,51552,49323,40579,60931,9861,73645,8594,134576,18455,"Onslow County, North Carolina(6,10)",85.5,101,"Onslow County, North Carolina",61.5,70,falling,186311,37,133,61.5,85.5
NC,"Orange County, North Carolina",20236,8668,11568,37135,59290,64065,36400,37949,72632,41906,58773,6925,66098,6134,124871,13059,"Orange County, North Carolina(6,10)",57.5,69,"Orange County, North Carolina",42.8,50,falling,141354,37,135,42.8,57.5
NC,"Pamlico County, North Carolina",1674,715,959,37137,43444,51694,24833,NA,65750,50239,5137,963,5386,863,10523,1826,"Pamlico County, North Carolina(6,10)",83.3,19,"Pamlico County, North Carolina",42.2,10,falling,12781,37,137,42.2,83.3
NC,"Pasquotank County, North Carolina",7256,2976,4280,37139,45378,53724,32445,NA,NA,NA,15561,2888,17386,2810,32947,5698,"Pasquotank County, North Carolina(6,10)",68.8,32,"Pasquotank County, North Carolina",59.5,27,stable,39829,37,139,59.5,68.8
NC,"Pender County, North Carolina",9925,4191,5734,37141,44828,51531,27000,29375,NA,28941,21808,4329,23069,4293,44877,8622,"Pender County, North Carolina(6,10)",70.9,49,"Pender County, North Carolina",51.1,36,stable,57611,37,141,51.1,70.9
NC,"Perquimans County, North Carolina",2626,1160,1466,37143,44329,47340,23326,NA,NA,21771,5224,1107,5893,1157,11117,2264,"Perquimans County, North Carolina(6,10)",68.9,15,"Perquimans County, North Carolina",48.2,10,stable,13440,37,143,48.2,68.9
NC,"Person County, North Carolina",7708,3574,4134,37145,42105,46875,27679,37917,NA,24500,15990,2909,17796,2138,33786,5047,"Person County, North Carolina(6,10)",84.6,42,"Person County, North Carolina",63.4,32,stable,39259,37,145,63.4,84.6
NC,"Pitt County, North Carolina",42743,18057,24686,37147,41119,50251,27672,76859,52750,29151,69019,12197,79254,12067,148273,24264,"Pitt County, North Carolina(6,10)",62.9,95,"Pitt County, North Carolina",48,71,falling,175842,37,147,48,62.9
NC,"Polk County, North Carolina",2790,1322,1468,37149,46528,48295,22292,NA,NA,46806,8521,1162,8990,1384,17511,2546,"Polk County, North Carolina(6,10)",50.3,19,"Polk County, North Carolina",40.8,15,falling,20366,37,149,40.8,50.3
NC,"Randolph County, North Carolina",24770,11758,13012,37151,41947,43258,34034,38320,36344,33176,57242,12444,60274,11241,117516,23685,"Randolph County, North Carolina(6,10)",86.5,147,"Randolph County, North Carolina",60.2,103,stable,142799,37,151,60.2,86.5
NC,"Richmond County, North Carolina",11465,5045,6420,37153,32687,38169,22797,35114,NA,21866,17202,4131,19468,3935,36670,8066,"Richmond County, North Carolina(6,10)",85.7,49,"Richmond County, North Carolina",64.5,37,stable,45437,37,153,64.5,85.7
NC,"Robeson County, North Carolina",41538,18723,22815,37155,30608,38394,24404,28680,34028,27823,49747,13868,56491,12539,106238,26407,"Robeson County, North Carolina(6,10)",69.2,95,"Robeson County, North Carolina",58.4,79,stable,134197,37,155,58.4,69.2
NC,"Rockingham County, North Carolina",16968,7168,9800,37157,38126,41852,27470,20556,23359,28031,38006,6007,41536,5754,79542,11761,"Rockingham County, North Carolina(6,10)",89.9,113,"Rockingham County, North Carolina",60.2,75,stable,91758,37,157,60.2,89.9
NC,"Rowan County, North Carolina",24194,10656,13538,37159,43069,47425,28766,NA,NA,37112,55135,11191,60050,9456,115185,20647,"Rowan County, North Carolina(6,10)",85.9,144,"Rowan County, North Carolina",58.5,98,stable,139142,37,159,58.5,85.9
NC,"Rutherford County, North Carolina",13077,5970,7107,37161,35630,37061,25833,29191,42411,38320,26825,5113,29291,4740,56116,9853,"Rutherford County, North Carolina(6,10)",79.4,76,"Rutherford County, North Carolina",56.3,54,stable,66390,37,161,56.3,79.4
NC,"Sampson County, North Carolina",16050,7577,8473,37163,35490,41177,25927,31000,29375,33039,24731,6401,26787,5332,51518,11733,"Sampson County, North Carolina(6,10)",77.7,60,"Sampson County, North Carolina",60.4,46,stable,63724,37,163,60.4,77.7
NC,"Scotland County, North Carolina",10504,4613,5891,37165,30958,42317,18483,25192,50313,50500,13319,2850,15365,2603,28684,5453,"Scotland County, North Carolina(6,10)",84.5,36,"Scotland County, North Carolina",63.6,27,stable,35509,37,165,63.6,84.5
NC,"Stanly County, North Carolina",10356,4702,5654,37167,40910,43011,23048,80086,40461,26864,25359,3955,25850,4026,51209,7981,"Stanly County, North Carolina(6,10)",80.4,64,"Stanly County, North Carolina",55.8,43,stable,60714,37,167,55.8,80.4
NC,"Stokes County, North Carolina",7826,3615,4211,37169,40696,40912,30000,50030,114063,33929,19445,3237,20499,3040,39944,6277,"Stokes County, North Carolina(6,10)",90.6,58,"Stokes County, North Carolina",65.5,41,stable,46351,37,169,65.5,90.6
NC,"Surry County, North Carolina",14195,6484,7711,37171,36164,36697,23427,NA,46154,33565,29052,6524,31220,5627,60272,12151,"Surry County, North Carolina(6,10)",82.9,83,"Surry County, North Carolina",67.8,68,stable,72743,37,171,67.8,82.9
NC,"Swain County, North Carolina",3409,1553,1856,37173,33931,38229,NA,22360,NA,NA,5139,1619,5775,1441,10914,3060,"Swain County, North Carolina(6,10)",95.5,18,"Swain County, North Carolina",66.8,13,stable,14434,37,173,66.8,95.5
NC,"Transylvania County, North Carolina",4017,1819,2198,37175,45114,45947,38125,NA,NA,26344,12650,3093,13899,2805,26549,5898,"Transylvania County, North Carolina(6,10)",53.6,33,"Transylvania County, North Carolina",37.2,23,falling,33211,37,175,37.2,53.6
NC,"Tyrrell County, North Carolina",779,326,453,37177,32361,35074,21074,NA,NA,36000,1415,413,1396,343,2811,756,"Tyrrell County, North Carolina(6,10)",97.5,6,"Tyrrell County, North Carolina",60,3,stable,4070,37,177,60,97.5
NC,"Union County, North Carolina",21416,10081,11335,37179,65903,69282,46942,54227,112669,45712,91176,13811,95909,11579,187085,25390,"Union County, North Carolina(6,10)",62.9,113,"Union County, North Carolina",46.5,80,stable,222742,37,179,46.5,62.9
NC,"Vance County, North Carolina",11064,4926,6138,37181,33316,44415,26095,41750,46544,35920,16836,3892,20309,3338,37145,7230,"Vance County, North Carolina(6,10)",71,39,"Vance County, North Carolina",53.2,29,falling,44568,37,181,53.2,71
NC,"Wake County, North Carolina",107687,49166,58521,37183,67309,77090,44597,54904,91219,42371,410336,59667,444583,52804,854919,112471,"Wake County, North Carolina(6,10)",55.9,406,"Wake County, North Carolina",38.8,274,falling,1024198,37,183,38.8,55.9
NC,"Warren County, North Carolina",4692,2290,2402,37185,34254,47514,25938,25602,NA,30491,7584,1876,8704,1288,16288,3164,"Warren County, North Carolina(6,10)",81.7,26,"Warren County, North Carolina",71.8,23,stable,20155,37,185,71.8,81.7
NC,"Washington County, North Carolina",2737,841,1896,37187,34538,44692,23253,NA,NA,37725,5022,764,5787,957,10809,1721,"Washington County, North Carolina(6,10)",58.6,11,"Washington County, North Carolina",45.4,9,stable,12385,37,187,45.4,58.6
NC,"Watauga County, North Carolina",14726,7773,6953,37189,37656,37961,50625,NA,NA,37125,23127,2754,23493,2583,46620,5337,"Watauga County, North Carolina(6,10)",51.4,26,"Watauga County, North Carolina",33.5,17,stable,52906,37,189,33.5,51.4
NC,"Wayne County, North Carolina",27037,11517,15520,37191,40390,49244,31059,NA,35968,26594,48265,9082,53636,8801,101901,17883,"Wayne County, North Carolina(6,10)",76.6,105,"Wayne County, North Carolina",58.2,79,falling,124132,37,191,58.2,76.6
NC,"Wilkes County, North Carolina",15791,7521,8270,37193,33232,33886,31173,NA,NA,26088,27936,5578,30011,4561,57947,10139,"Wilkes County, North Carolina(6,10)",77.2,75,"Wilkes County, North Carolina",58.5,57,stable,68502,37,193,58.5,77.2
NC,"Wilson County, North Carolina",18475,8116,10359,37195,39847,51198,29420,NA,92857,33246,30989,7122,35996,6337,66985,13459,"Wilson County, North Carolina(6,10)",71.2,71,"Wilson County, North Carolina",55.8,55,falling,81714,37,195,55.8,71.2
NC,"Yadkin County, North Carolina",7643,3528,4115,37197,37796,38488,24332,NA,NA,36838,15503,3106,16609,2487,32112,5593,"Yadkin County, North Carolina(6,10)",82.2,42,"Yadkin County, North Carolina",52.6,27,stable,37585,37,197,52.6,82.2
NC,"Yancey County, North Carolina",3775,1653,2122,37199,37484,37870,37993,NA,NA,14744,6997,1488,7526,1415,14523,2903,"Yancey County, North Carolina(6,10)",86.3,25,"Yancey County, North Carolina",53.1,15,stable,17587,37,199,53.1,86.3
ND,"Adams County, North Dakota",220,90,130,38001,52118,55700,NA,NA,44375,NA,1062,115,1028,86,2090,201,"Adams County, North Dakota(6,10)",*,3 or fewer,"Adams County, North Dakota",*,*,**,2359,38,1,NA,NA
ND,"Barnes County, North Dakota",841,396,445,38003,53141,54880,NA,NA,18932,57841,4956,505,5111,332,10067,837,"Barnes County, North Dakota(6,10)",64.5,10,"Barnes County, North Dakota",41.8,7,stable,11099,38,3,41.8,64.5
ND,"Benson County, North Dakota",2260,1070,1190,38005,41296,50545,NA,28510,NA,59107,2752,732,2757,538,5509,1270,"Benson County, North Dakota(6,10)",59.4,4,"Benson County, North Dakota",*,*,**,6753,38,5,NA,59.4
ND,"Billings County, North Dakota",100,49,51,38007,70469,71719,NA,NA,NA,NA,506,76,349,38,855,114,"Billings County, North Dakota(6,10)",*,3 or fewer,"Billings County, North Dakota",*,*,**,936,38,7,NA,NA
ND,"Bottineau County, North Dakota",540,188,352,38009,56349,57031,NA,23938,NA,NA,3109,328,2722,306,5831,634,"Bottineau County, North Dakota(6,10)",58.3,6,"Bottineau County, North Dakota",37.8,5,**,6716,38,9,37.8,58.3
ND,"Bowman County, North Dakota",234,80,154,38011,66845,66488,NA,NA,NA,83393,1461,91,1505,99,2966,190,"Bowman County, North Dakota(6,10)",81.7,4,"Bowman County, North Dakota",*,*,**,3294,38,11,NA,81.7
ND,"Burke County, North Dakota",301,124,177,38013,60096,60096,NA,NA,NA,28942,1040,168,869,130,1909,298,"Burke County, North Dakota(6,10)",*,3 or fewer,"Burke County, North Dakota",*,*,**,2308,38,13,NA,NA
ND,"Burleigh County, North Dakota",6946,3052,3894,38015,65254,66945,48958,20046,99291,44286,39076,3389,41128,2750,80204,6139,"Burleigh County, North Dakota(6,10)",52.2,49,"Burleigh County, North Dakota",34.4,32,stable,92991,38,15,34.4,52.2
ND,"Cass County, North Dakota",19082,8990,10092,38017,53289,55676,28045,26822,35690,34099,73605,7721,74144,5868,147749,13589,"Cass County, North Dakota(6,10)",59.8,80,"Cass County, North Dakota",37.3,50,falling,171512,38,17,37.3,59.8
ND,"Cavalier County, North Dakota",180,43,137,38019,66806,66250,NA,36136,NA,NA,1834,94,1812,54,3646,148,"Cavalier County, North Dakota(6,10)",50.3,4,"Cavalier County, North Dakota",*,*,*,3828,38,19,NA,50.3
ND,"Dickey County, North Dakota",400,151,249,38021,53750,54545,41250,55809,NA,31827,2339,243,2279,188,4618,431,"Dickey County, North Dakota(6,10)",49.6,4,"Dickey County, North Dakota",*,*,*,5104,38,21,NA,49.6
ND,"Divide County, North Dakota",178,72,106,38023,56042,56417,NA,NA,NA,NA,1048,109,1000,100,2048,209,"Divide County, North Dakota(6,10)",*,3 or fewer,"Divide County, North Dakota",*,*,**,2450,38,23,NA,NA
ND,"Dunn County, North Dakota",517,246,271,38025,69732,76484,NA,42596,NA,58750,1790,412,1626,315,3416,727,"Dunn County, North Dakota(6,10)",*,3 or fewer,"Dunn County, North Dakota",*,*,**,4646,38,25,NA,NA
ND,"Eddy County, North Dakota",311,166,145,38027,48583,49896,NA,38500,NA,NA,992,102,1137,65,2129,167,"Eddy County, North Dakota(6,10)",*,3 or fewer,"Eddy County, North Dakota",*,*,**,2365,38,27,NA,NA
ND,"Emmons County, North Dakota",386,166,220,38029,44051,43168,NA,NA,NA,NA,1597,129,1536,146,3133,275,"Emmons County, North Dakota(6,10)",43.3,3,"Emmons County, North Dakota",*,*,*,3402,38,29,NA,43.3
ND,"Foster County, North Dakota",316,107,209,38031,55769,55962,NA,NA,NA,NA,1528,127,1542,103,3070,230,"Foster County, North Dakota(6,10)",*,3 or fewer,"Foster County, North Dakota",*,*,**,3356,38,31,NA,NA
ND,"Golden Valley County, North Dakota",177,68,109,38033,40179,40179,NA,NA,NA,NA,692,148,833,94,1525,242,"Golden Valley County, North Dakota(6,10)",*,3 or fewer,"Golden Valley County, North Dakota",*,*,**,1845,38,33,NA,NA
ND,"Grand Forks County, North Dakota",11223,5076,6147,38035,48676,50367,27083,24551,51719,56310,31352,2691,30830,2197,62182,4888,"Grand Forks County, North Dakota(6,10)",59.7,36,"Grand Forks County, North Dakota",42.6,26,falling,70916,38,35,42.6,59.7
ND,"Grant County, North Dakota",346,143,203,38037,44559,45000,NA,42917,NA,NA,1021,126,1066,110,2087,236,"Grant County, North Dakota(6,10)",*,3 or fewer,"Grant County, North Dakota",*,*,**,2388,38,37,NA,NA
ND,"Griggs County, North Dakota",179,78,101,38039,48355,50956,NA,NA,NA,NA,1047,98,1002,91,2049,189,"Griggs County, North Dakota(6,10)",*,3 or fewer,"Griggs County, North Dakota",76.8,4,**,2314,38,39,76.8,NA
ND,"Hettinger County, North Dakota",217,70,147,38041,52169,52243,NA,NA,NA,NA,1145,96,1135,83,2280,179,"Hettinger County, North Dakota(6,10)",*,3 or fewer,"Hettinger County, North Dakota",*,*,**,2704,38,41,NA,NA
ND,"Kidder County, North Dakota",185,86,99,38043,54559,54804,NA,NA,NA,38050,1144,135,1080,71,2224,206,"Kidder County, North Dakota(6,10)",*,3 or fewer,"Kidder County, North Dakota",*,*,**,2417,38,43,NA,NA
ND,"LaMoure County, North Dakota",383,152,231,38045,54821,55347,NA,NA,NA,NA,1920,195,1838,91,3758,286,"LaMoure County, North Dakota(6,10)",*,3 or fewer,"LaMoure County, North Dakota",*,*,**,4125,38,45,NA,NA
ND,"Logan County, North Dakota",151,62,89,38047,51458,51042,NA,NA,NA,NA,867,46,916,41,1783,87,"Logan County, North Dakota(6,10)",*,3 or fewer,"Logan County, North Dakota",*,*,**,1935,38,47,NA,NA
ND,"McHenry County, North Dakota",738,333,405,38049,57386,57799,NA,NA,NA,27000,2706,302,2545,185,5251,487,"McHenry County, North Dakota(6,10)",63.6,6,"McHenry County, North Dakota",41.7,4,**,5968,38,49,41.7,63.6
ND,"McIntosh County, North Dakota",311,80,231,38051,42277,43333,NA,NA,NA,NA,1236,58,1312,41,2548,99,"McIntosh County, North Dakota(6,10)",*,3 or fewer,"McIntosh County, North Dakota",*,*,**,2759,38,51,NA,NA
ND,"McKenzie County, North Dakota",1309,670,639,38053,72794,82838,NA,32500,NA,NA,3968,1083,3710,788,7678,1871,"McKenzie County, North Dakota(6,10)",43.5,3,"McKenzie County, North Dakota",*,*,**,12826,38,53,NA,43.5
ND,"McLean County, North Dakota",1072,441,631,38055,55686,56065,NA,47750,NA,NA,4285,392,4129,455,8414,847,"McLean County, North Dakota(6,10)",53.4,8,"McLean County, North Dakota",35.1,5,stable,9744,38,55,35.1,53.4
ND,"Mercer County, North Dakota",693,217,476,38057,72704,73260,NA,38889,43750,92125,4014,424,3668,415,7682,839,"Mercer County, North Dakota(6,10)",50.6,6,"Mercer County, North Dakota",36.8,4,stable,8853,38,57,36.8,50.6
ND,"Morton County, North Dakota",2270,1079,1191,38059,62418,63120,30903,63333,NA,56827,13459,1052,13184,743,26643,1795,"Morton County, North Dakota(6,10)",68.7,24,"Morton County, North Dakota",45.2,16,stable,30310,38,59,45.2,68.7
ND,"Mountrail County, North Dakota",1226,608,618,38061,68188,71691,NA,51193,NA,68380,4094,916,3434,711,7528,1627,"Mountrail County, North Dakota(6,10)",70.9,6,"Mountrail County, North Dakota",48.9,4,**,10331,38,61,48.9,70.9
ND,"Nelson County, North Dakota",249,105,144,38063,51085,50991,NA,32361,NA,NA,1391,146,1300,129,2691,275,"Nelson County, North Dakota(6,10)",71.9,4,"Nelson County, North Dakota",*,*,**,2968,38,63,NA,71.9
ND,"Oliver County, North Dakota",137,66,71,38065,60278,60139,NA,66458,NA,NA,834,110,795,80,1629,190,"Oliver County, North Dakota(6,10)",*,3 or fewer,"Oliver County, North Dakota",*,*,**,1846,38,65,NA,NA
ND,"Pembina County, North Dakota",454,193,261,38067,53504,54531,NA,25625,NA,38250,3282,335,3222,203,6504,538,"Pembina County, North Dakota(6,10)",65.2,8,"Pembina County, North Dakota",56.7,7,stable,7091,38,67,56.7,65.2
ND,"Pierce County, North Dakota",693,307,386,38069,42563,42750,NA,NA,NA,NA,1806,305,1965,128,3771,433,"Pierce County, North Dakota(6,10)",41,3,"Pierce County, North Dakota",*,*,**,4312,38,69,NA,41
ND,"Ramsey County, North Dakota",1118,565,553,38071,50841,51556,NA,41016,NA,66121,4968,632,4974,491,9942,1123,"Ramsey County, North Dakota(6,10)",73.7,11,"Ramsey County, North Dakota",53.2,8,stable,11630,38,71,53.2,73.7
ND,"Ransom County, North Dakota",490,191,299,38073,56500,56446,NA,31339,NA,NA,2547,172,2450,132,4997,304,"Ransom County, North Dakota(6,10)",67.9,6,"Ransom County, North Dakota",55.3,5,stable,5448,38,73,55.3,67.9
ND,"Renville County, North Dakota",186,85,101,38075,65125,66063,NA,NA,NA,NA,1192,65,1158,66,2350,131,"Renville County, North Dakota(6,10)",*,3 or fewer,"Renville County, North Dakota",*,*,**,2571,38,75,NA,NA
ND,"Richland County, North Dakota",1633,659,974,38077,55390,56304,NA,NA,NA,39028,7869,465,7377,436,15246,901,"Richland County, North Dakota(6,10)",45.2,9,"Richland County, North Dakota",33.2,6,stable,16402,38,77,33.2,45.2
ND,"Rolette County, North Dakota",5054,2207,2847,38079,33277,45903,NA,27191,NA,NA,4522,2528,5293,2031,9815,4559,"Rolette County, North Dakota(6,10)",76.5,10,"Rolette County, North Dakota",72.2,9,stable,14649,38,79,72.2,76.5
ND,"Sargent County, North Dakota",222,80,142,38081,57125,57042,NA,NA,NA,56429,1933,97,1740,67,3673,164,"Sargent County, North Dakota(6,10)",100,6,"Sargent County, North Dakota",*,*,**,3876,38,81,NA,100
ND,"Sheridan County, North Dakota",209,65,144,38083,48102,48287,NA,NA,NA,NA,618,50,626,43,1244,93,"Sheridan County, North Dakota(6,10)",*,3 or fewer,"Sheridan County, North Dakota",*,*,**,1310,38,83,NA,NA
ND,"Sioux County, North Dakota",1524,717,807,38085,38068,59375,NA,33672,NA,45000,1431,752,1664,486,3095,1238,"Sioux County, North Dakota(6,10)",*,3 or fewer,"Sioux County, North Dakota",*,*,**,4370,38,85,NA,NA
ND,"Slope County, North Dakota",68,33,35,38087,55000,57031,NA,NA,NA,NA,341,35,279,18,620,53,"Slope County, North Dakota(6,10)",*,3 or fewer,"Slope County, North Dakota",*,*,**,767,38,87,NA,NA
ND,"Stark County, North Dakota",1866,755,1111,38089,72099,73907,29525,47955,2499,60633,13171,1442,12384,1177,25555,2619,"Stark County, North Dakota(6,10)",42.7,13,"Stark County, North Dakota",32.4,10,stable,32154,38,89,32.4,42.7
ND,"Steele County, North Dakota",143,74,69,38091,55833,55833,NA,NA,NA,NA,979,55,872,73,1851,128,"Steele County, North Dakota(6,10)",*,3 or fewer,"Steele County, North Dakota",*,*,**,1956,38,91,NA,NA
ND,"Stutsman County, North Dakota",2130,854,1276,38093,52359,52685,NA,NA,NA,65688,9124,970,9324,745,18448,1715,"Stutsman County, North Dakota(6,10)",56.5,17,"Stutsman County, North Dakota",51.2,16,stable,21103,38,93,51.2,56.5
ND,"Towner County, North Dakota",316,126,190,38095,56625,62083,NA,NA,NA,NA,1021,92,1061,85,2082,177,"Towner County, North Dakota(6,10)",*,3 or fewer,"Towner County, North Dakota",*,*,**,2272,38,95,NA,NA
ND,"Traill County, North Dakota",804,436,368,38097,54960,56155,NA,21477,NA,NA,3777,223,3741,156,7518,379,"Traill County, North Dakota(6,10)",62,7,"Traill County, North Dakota",41.6,5,rising,8014,38,97,41.6,62
ND,"Walsh County, North Dakota",1112,464,648,38099,49411,49766,NA,25625,NA,36681,4913,667,4880,367,9793,1034,"Walsh County, North Dakota(6,10)",56.7,10,"Walsh County, North Dakota",42.8,8,stable,10897,38,99,42.8,56.7
ND,"Ward County, North Dakota",4919,1861,3058,38101,61393,61980,61863,21612,NA,41606,28609,3115,29757,2358,58366,5473,"Ward County, North Dakota(6,10)",64.6,41,"Ward County, North Dakota",44.2,29,stable,71275,38,101,44.2,64.6
ND,"Wells County, North Dakota",226,110,116,38103,48098,48424,NA,NA,NA,NA,1929,180,1857,153,3786,333,"Wells County, North Dakota(6,10)",40.6,4,"Wells County, North Dakota",45.7,4,stable,4168,38,103,45.7,40.6
ND,"Williams County, North Dakota",2913,1402,1511,38105,88013,90664,19520,57904,NA,39151,14385,1497,11912,1468,26297,2965,"Williams County, North Dakota(6,10)",53.9,14,"Williams County, North Dakota",46.5,12,stable,35294,38,105,46.5,53.9
NE,"Adams County, Nebraska",3499,1490,2009,31001,50635,50924,35096,43906,NA,52250,13894,1771,14127,1366,28021,3137,"Adams County, Nebraska(6,10)",62.7,24,"Adams County, Nebraska",45,18,stable,31587,31,1,45,62.7
NE,"Antelope County, Nebraska",811,353,458,31003,45609,45365,NA,NA,NA,NA,2880,305,2920,284,5800,589,"Antelope County, Nebraska(6,10)",51.1,6,"Antelope County, Nebraska",39.7,4,**,6414,31,3,39.7,51.1
NE,"Arthur County, Nebraska",36,19,17,31005,39375,40000,NA,NA,NA,NA,194,29,200,25,394,54,"Arthur County, Nebraska(6,10)",*,3 or fewer,"Arthur County, Nebraska",*,*,**,456,31,5,NA,NA
NE,"Banner County, Nebraska",96,30,66,31007,48897,49118,NA,NA,NA,NA,355,44,365,56,720,100,"Banner County, Nebraska(6,10)",*,3 or fewer,"Banner County, Nebraska",*,*,**,788,31,7,NA,NA
NE,"Blaine County, Nebraska",106,61,45,31009,48875,49375,NA,NA,NA,NA,214,79,207,51,421,130,"Blaine County, Nebraska(6,10)",*,3 or fewer,"Blaine County, Nebraska",*,*,**,487,31,9,NA,NA
NE,"Boone County, Nebraska",533,208,325,31011,50306,50332,NA,NA,NA,57500,2453,181,2430,211,4883,392,"Boone County, Nebraska(6,10)",50.2,4,"Boone County, Nebraska",*,*,**,5315,31,11,NA,50.2
NE,"Box Butte County, Nebraska",1886,758,1128,31013,51691,51967,NA,21765,NA,39216,5247,428,4956,515,10203,943,"Box Butte County, Nebraska(6,10)",48.9,7,"Box Butte County, Nebraska",31.2,5,stable,11337,31,13,31.2,48.9
NE,"Boyd County, Nebraska",220,97,123,31015,40224,40353,NA,53750,NA,NA,894,132,883,103,1777,235,"Boyd County, Nebraska(6,10)",*,3 or fewer,"Boyd County, Nebraska",*,*,**,2006,31,15,NA,NA
NE,"Brown County, Nebraska",499,241,258,31017,36078,36250,NA,NA,NA,NA,1283,172,1322,257,2605,429,"Brown County, Nebraska(6,10)",*,3 or fewer,"Brown County, Nebraska",*,*,**,2946,31,17,NA,NA
NE,"Buffalo County, Nebraska",5978,2737,3241,31019,53624,55005,21652,NA,16189,43438,21439,2104,22245,1568,43684,3672,"Buffalo County, Nebraska(6,10)",49.3,23,"Buffalo County, Nebraska",36,16,stable,48863,31,19,36,49.3
NE,"Burt County, Nebraska",620,265,355,31021,47429,47931,NA,NA,NA,32917,2967,283,2957,338,5924,621,"Burt County, Nebraska(6,10)",66.2,7,"Burt County, Nebraska",58.7,6,stable,6585,31,21,58.7,66.2
NE,"Butler County, Nebraska",682,309,373,31023,51027,51498,NA,NA,NA,43661,3741,371,3701,272,7442,643,"Butler County, Nebraska(6,10)",48,6,"Butler County, Nebraska",36.9,5,stable,8115,31,23,36.9,48
NE,"Cass County, Nebraska",1556,739,817,31025,65619,65818,NA,70357,NA,80875,11685,773,11691,780,23376,1553,"Cass County, Nebraska(6,10)",65.5,19,"Cass County, Nebraska",50.4,15,stable,25512,31,25,50.4,65.5
NE,"Cedar County, Nebraska",864,385,479,31027,52250,52500,NA,NA,NA,25313,4089,267,3947,224,8036,491,"Cedar County, Nebraska(6,10)",32.5,5,"Cedar County, Nebraska",28.2,4,stable,8564,31,27,28.2,32.5
NE,"Chase County, Nebraska",337,161,176,31029,52422,53365,NA,NA,NA,28824,1627,243,1704,256,3331,499,"Chase County, Nebraska(6,10)",77.6,5,"Chase County, Nebraska",59.1,4,stable,3956,31,29,59.1,77.6
NE,"Cherry County, Nebraska",648,175,473,31031,48750,49394,NA,21136,NA,NA,2495,209,2679,328,5174,537,"Cherry County, Nebraska(6,10)",38.1,3,"Cherry County, Nebraska",36.4,3,stable,5848,31,31,36.4,38.1
NE,"Cheyenne County, Nebraska",1150,420,730,31033,53814,53584,NA,NA,NA,NA,4538,380,4707,353,9245,733,"Cheyenne County, Nebraska(6,10)",60.7,8,"Cheyenne County, Nebraska",47.2,6,stable,10167,31,33,47.2,60.7
NE,"Clay County, Nebraska",580,233,347,31035,51470,51740,NA,NA,NA,31875,2836,362,2704,376,5540,738,"Clay County, Nebraska(6,10)",54.1,5,"Clay County, Nebraska",41.9,4,stable,6309,31,35,41.9,54.1
NE,"Colfax County, Nebraska",1374,675,699,31037,51367,51870,43657,NA,NA,49615,4633,786,4333,680,8966,1466,"Colfax County, Nebraska(6,10)",45.9,5,"Colfax County, Nebraska",33.1,4,stable,10520,31,37,33.1,45.9
NE,"Cuming County, Nebraska",1071,376,695,31039,50013,50672,NA,NA,NA,31750,4041,437,4058,391,8099,828,"Cuming County, Nebraska(6,10)",41.6,6,"Cuming County, Nebraska",34.1,5,stable,9125,31,39,34.1,41.6
NE,"Custer County, Nebraska",1200,526,674,31041,46468,46723,NA,NA,NA,35208,4558,716,4818,587,9376,1303,"Custer County, Nebraska(6,10)",48.3,8,"Custer County, Nebraska",42.2,7,stable,10806,31,41,42.2,48.3
NE,"Dakota County, Nebraska",3528,1510,2018,31043,49786,54669,6760,10707,56588,45793,8405,1570,8872,1735,17277,3305,"Dakota County, Nebraska(6,10)",73,15,"Dakota County, Nebraska",53,11,stable,20781,31,43,53,73
NE,"Dawes County, Nebraska",1428,531,897,31045,41038,44259,NA,7004,NA,NA,3715,645,3960,741,7675,1386,"Dawes County, Nebraska(6,10)",43.8,5,"Dawes County, Nebraska",28.9,4,**,9055,31,45,28.9,43.8
NE,"Dawson County, Nebraska",3618,1439,2179,31047,48329,48471,44102,50833,NA,39250,10328,1645,10323,1499,20651,3144,"Dawson County, Nebraska(6,10)",45.9,13,"Dawson County, Nebraska",36.9,10,stable,23886,31,47,36.9,45.9
NE,"Deuel County, Nebraska",246,90,156,31049,50962,51058,NA,39250,NA,31406,824,147,827,127,1651,274,"Deuel County, Nebraska(6,10)",*,3 or fewer,"Deuel County, Nebraska",*,*,**,1921,31,49,NA,NA
NE,"Dixon County, Nebraska",683,309,374,31051,51223,51168,NA,NA,NA,44750,2521,356,2582,322,5103,678,"Dixon County, Nebraska(6,10)",63.3,6,"Dixon County, Nebraska",35.5,3,**,5797,31,51,35.5,63.3
NE,"Dodge County, Nebraska",4061,1819,2242,31053,49068,49435,NA,NA,58375,32939,15521,2220,16362,2033,31883,4253,"Dodge County, Nebraska(6,10)",70.2,36,"Dodge County, Nebraska",51.8,27,stable,36706,31,53,51.8,70.2
NE,"Douglas County, Nebraska",76738,33674,43064,31055,54659,60685,27381,28438,52180,39282,228496,32282,242959,27736,471455,60018,"Douglas County, Nebraska(6,10)",69.5,338,"Douglas County, Nebraska",51,245,falling,550064,31,55,51,69.5
NE,"Dundy County, Nebraska",151,69,82,31057,42500,42386,NA,NA,NA,38423,873,162,821,121,1694,283,"Dundy County, Nebraska(6,10)",*,3 or fewer,"Dundy County, Nebraska",*,*,**,1799,31,57,NA,NA
NE,"Fillmore County, Nebraska",514,167,347,31059,52316,52700,NA,NA,NA,NA,2426,307,2483,249,4909,556,"Fillmore County, Nebraska(6,10)",48.1,5,"Fillmore County, Nebraska",40.6,4,**,5619,31,59,40.6,48.1
NE,"Franklin County, Nebraska",396,183,213,31061,45905,46574,NA,NA,16250,84063,1415,124,1370,134,2785,258,"Franklin County, Nebraska(6,10)",*,3 or fewer,"Franklin County, Nebraska",*,*,**,2985,31,61,NA,NA
NE,"Frontier County, Nebraska",305,113,192,31063,49634,49507,NA,NA,NA,NA,1170,127,1120,147,2290,274,"Frontier County, Nebraska(6,10)",*,3 or fewer,"Frontier County, Nebraska",*,*,**,2624,31,63,NA,NA
NE,"Furnas County, Nebraska",820,337,483,31065,39934,40333,NA,NA,NA,NA,2110,248,2178,269,4288,517,"Furnas County, Nebraska(6,10)",65.8,5,"Furnas County, Nebraska",*,*,**,4862,31,65,NA,65.8
NE,"Gage County, Nebraska",2080,925,1155,31067,50010,49569,NA,33563,NA,NA,9878,830,10192,633,20070,1463,"Gage County, Nebraska(6,10)",59.5,19,"Gage County, Nebraska",40.6,13,stable,21900,31,67,40.6,59.5
NE,"Garden County, Nebraska",181,81,100,31069,45845,45845,NA,NA,NA,NA,747,136,779,120,1526,256,"Garden County, Nebraska(6,10)",*,3 or fewer,"Garden County, Nebraska",*,*,**,1918,31,69,NA,NA
NE,"Garfield County, Nebraska",193,63,130,31071,43179,43750,NA,NA,NA,NA,836,100,877,85,1713,185,"Garfield County, Nebraska(6,10)",*,3 or fewer,"Garfield County, Nebraska",*,*,**,2028,31,71,NA,NA
NE,"Gosper County, Nebraska",110,44,66,31073,54375,54615,NA,NA,NA,NA,848,93,915,82,1763,175,"Gosper County, Nebraska(6,10)",*,3 or fewer,"Gosper County, Nebraska",*,*,**,1973,31,73,NA,NA
NE,"Grant County, Nebraska",98,47,51,31075,44750,44750,NA,NA,NA,NA,335,57,338,39,673,96,"Grant County, Nebraska(6,10)",*,3 or fewer,"Grant County, Nebraska",*,*,**,641,31,75,NA,NA
NE,"Greeley County, Nebraska",243,97,146,31077,42904,43125,NA,NA,NA,NA,1122,103,1098,120,2220,223,"Greeley County, Nebraska(6,10)",*,3 or fewer,"Greeley County, Nebraska",*,*,**,2429,31,77,NA,NA
NE,"Hall County, Nebraska",9092,3927,5165,31079,49252,49560,30368,61055,58167,36321,25029,4904,25624,4458,50653,9362,"Hall County, Nebraska(6,10)",57.8,38,"Hall County, Nebraska",38.9,25,falling,61680,31,79,38.9,57.8
NE,"Hamilton County, Nebraska",780,303,477,31081,59311,59567,NA,33958,NA,31538,4189,305,4244,219,8433,524,"Hamilton County, Nebraska(6,10)",48,6,"Hamilton County, Nebraska",34.1,4,stable,9190,31,81,34.1,48
NE,"Harlan County, Nebraska",450,215,235,31083,46766,46495,NA,NA,NA,34583,1610,185,1423,187,3033,372,"Harlan County, Nebraska(6,10)",*,3 or fewer,"Harlan County, Nebraska",*,*,**,3452,31,83,NA,NA
NE,"Hayes County, Nebraska",68,36,32,31085,44500,44450,NA,NA,NA,34375,475,117,406,86,881,203,"Hayes County, Nebraska(6,10)",*,3 or fewer,"Hayes County, Nebraska",*,*,**,932,31,85,NA,NA
NE,"Hitchcock County, Nebraska",490,237,253,31087,39231,39103,NA,NA,NA,NA,1261,194,1179,211,2440,405,"Hitchcock County, Nebraska(6,10)",*,3 or fewer,"Hitchcock County, Nebraska",*,*,**,2883,31,87,NA,NA
NE,"Holt County, Nebraska",1209,512,697,31089,46728,46653,NA,NA,NA,31364,4599,482,4691,461,9290,943,"Holt County, Nebraska(6,10)",49.5,8,"Holt County, Nebraska",46.6,8,stable,10313,31,89,46.6,49.5
NE,"Hooker County, Nebraska",123,71,52,31091,37317,37647,NA,NA,NA,62917,286,32,310,26,596,58,"Hooker County, Nebraska(6,10)",*,3 or fewer,"Hooker County, Nebraska",*,*,**,732,31,91,NA,NA
NE,"Howard County, Nebraska",658,333,325,31093,50030,50476,NA,NA,NA,26750,2996,238,2953,140,5949,378,"Howard County, Nebraska(6,10)",54.1,5,"Howard County, Nebraska",43.2,4,stable,6409,31,93,43.2,54.1
NE,"Jefferson County, Nebraska",909,361,548,31095,43008,43118,NA,NA,NA,NA,3352,253,3390,325,6742,578,"Jefferson County, Nebraska(6,10)",65.2,8,"Jefferson County, Nebraska",50.1,6,stable,7263,31,95,50.1,65.2
NE,"Johnson County, Nebraska",471,214,257,31097,45429,46607,NA,NA,41625,23167,1770,187,1845,212,3615,399,"Johnson County, Nebraska(6,10)",97.5,7,"Johnson County, Nebraska",46.6,3,**,5173,31,97,46.6,97.5
NE,"Kearney County, Nebraska",408,181,227,31099,51934,52422,NA,NA,NA,60978,2928,277,2976,285,5904,562,"Kearney County, Nebraska(6,10)",60.8,6,"Kearney County, Nebraska",47.6,4,**,6585,31,99,47.6,60.8
NE,"Keith County, Nebraska",931,393,538,31101,41781,41710,NA,NA,NA,31850,3516,521,3500,547,7016,1068,"Keith County, Nebraska(6,10)",49.2,7,"Keith County, Nebraska",37.9,5,stable,8063,31,101,37.9,49.2
NE,"Keya Paha County, Nebraska",106,41,65,31103,38625,39250,NA,NA,NA,NA,342,26,319,24,661,50,"Keya Paha County, Nebraska(6,10)",*,3 or fewer,"Keya Paha County, Nebraska",*,*,**,804,31,103,NA,NA
NE,"Kimball County, Nebraska",496,205,291,31105,40242,39318,NA,NA,56250,21705,1535,289,1542,296,3077,585,"Kimball County, Nebraska(6,10)",60.6,4,"Kimball County, Nebraska",49.9,3,stable,3689,31,105,49.9,60.6
NE,"Knox County, Nebraska",1117,426,691,31107,45411,48442,NA,30742,53750,47656,3614,462,3751,498,7365,960,"Knox County, Nebraska(6,10)",59.3,8,"Knox County, Nebraska",51.7,8,stable,8543,31,107,51.7,59.3
NE,"Lancaster County, Nebraska",41796,18624,23172,31109,51830,54189,30184,26154,40354,35569,129832,16174,135393,12304,265225,28478,"Lancaster County, Nebraska(6,10)",57.3,155,"Lancaster County, Nebraska",41.6,112,falling,306468,31,109,41.6,57.3
NE,"Lincoln County, Nebraska",4488,1775,2713,31111,50194,50618,NA,2499,46121,34636,15665,1904,15915,2019,31580,3923,"Lincoln County, Nebraska(6,10)",57.1,26,"Lincoln County, Nebraska",44.2,20,stable,35656,31,111,44.2,57.1
NE,"Logan County, Nebraska",91,33,58,31113,48281,48438,NA,NA,NA,NA,360,51,406,33,766,84,"Logan County, Nebraska(6,10)",*,3 or fewer,"Logan County, Nebraska",*,*,**,777,31,113,NA,NA
NE,"Loup County, Nebraska",68,30,38,31115,55417,55104,NA,NA,NA,NA,246,26,257,19,503,45,"Loup County, Nebraska(6,10)",*,3 or fewer,"Loup County, Nebraska",*,*,**,585,31,115,NA,NA
NE,"McPherson County, Nebraska",64,32,32,31117,54306,54306,NA,NA,NA,NA,219,4,206,4,425,8,"McPherson County, Nebraska(6,10)",*,3 or fewer,"McPherson County, Nebraska",*,*,**,475,31,117,NA,NA
NE,"Madison County, Nebraska",5119,2075,3044,31119,50218,50463,NA,16000,230857,40474,15094,2026,15516,1830,30610,3856,"Madison County, Nebraska(6,10)",61.4,25,"Madison County, Nebraska",40.5,17,stable,35039,31,119,40.5,61.4
NE,"Merrick County, Nebraska",667,344,323,31121,51012,50826,NA,NA,NA,40556,3455,310,3494,402,6949,712,"Merrick County, Nebraska(6,10)",68,8,"Merrick County, Nebraska",44.9,5,stable,7787,31,121,44.9,68
NE,"Morrill County, Nebraska",550,259,291,31123,45910,45972,NA,NA,NA,30192,2065,358,2051,248,4116,606,"Morrill County, Nebraska(6,10)",71.6,5,"Morrill County, Nebraska",*,*,**,4854,31,123,NA,71.6
NE,"Nance County, Nebraska",490,253,237,31125,42500,42500,NA,NA,NA,NA,1553,218,1588,183,3141,401,"Nance County, Nebraska(6,10)",*,3 or fewer,"Nance County, Nebraska",*,*,**,3595,31,125,NA,NA
NE,"Nemaha County, Nebraska",574,300,274,31127,49656,50386,23077,NA,NA,NA,3100,292,3377,281,6477,573,"Nemaha County, Nebraska(6,10)",62.5,6,"Nemaha County, Nebraska",37.4,4,stable,7046,31,127,37.4,62.5
NE,"Nuckolls County, Nebraska",501,182,319,31129,40488,41555,NA,NA,NA,NA,1886,260,1979,184,3865,444,"Nuckolls County, Nebraska(6,10)",64.8,5,"Nuckolls County, Nebraska",45,4,falling,4329,31,129,45,64.8
NE,"Otoe County, Nebraska",1696,740,956,31131,50275,50725,NA,33152,NA,40054,6900,821,7198,634,14098,1455,"Otoe County, Nebraska(6,10)",59.6,13,"Otoe County, Nebraska",46.7,10,stable,15984,31,131,46.7,59.6
NE,"Pawnee County, Nebraska",446,207,239,31133,41161,41369,NA,NA,NA,46250,1107,261,1173,144,2280,405,"Pawnee County, Nebraska(6,10)",60.9,3,"Pawnee County, Nebraska",*,*,**,2659,31,133,NA,60.9
NE,"Perkins County, Nebraska",198,46,152,31135,55893,55774,NA,NA,NA,34000,1318,114,1322,129,2640,243,"Perkins County, Nebraska(6,10)",*,3 or fewer,"Perkins County, Nebraska",*,*,**,2944,31,135,NA,NA
NE,"Phelps County, Nebraska",706,213,493,31137,50404,50640,NA,NA,NA,34492,4142,364,4120,359,8262,723,"Phelps County, Nebraska(6,10)",44.3,6,"Phelps County, Nebraska",39.1,5,**,9296,31,137,39.1,44.3
NE,"Pierce County, Nebraska",417,174,243,31139,54482,54447,NA,NA,NA,NA,3276,287,3320,167,6596,454,"Pierce County, Nebraska(6,10)",56,6,"Pierce County, Nebraska",46.2,5,**,7208,31,139,46.2,56
NE,"Platte County, Nebraska",2728,1336,1392,31141,56318,56916,NA,NA,NA,46053,14472,1958,14421,1492,28893,3450,"Platte County, Nebraska(6,10)",54.9,21,"Platte County, Nebraska",40.8,16,stable,32847,31,141,40.8,54.9
NE,"Polk County, Nebraska",389,184,205,31143,57312,57568,NA,NA,NA,38750,2359,222,2388,187,4747,409,"Polk County, Nebraska(6,10)",65.7,5,"Polk County, Nebraska",48,4,**,5202,31,143,48,65.7
NE,"Red Willow County, Nebraska",1118,572,546,31145,42931,43472,NA,NA,NA,53875,4618,689,4948,430,9566,1119,"Red Willow County, Nebraska(6,10)",49.5,8,"Red Willow County, Nebraska",46.5,8,stable,10829,31,145,46.5,49.5
NE,"Richardson County, Nebraska",1557,690,867,31147,42750,45697,NA,NA,NA,21188,3711,319,3732,284,7443,603,"Richardson County, Nebraska(6,10)",60.6,8,"Richardson County, Nebraska",51.7,7,stable,8094,31,147,51.7,60.6
NE,"Rock County, Nebraska",162,48,114,31149,48456,48854,NA,NA,NA,NA,582,89,567,127,1149,216,"Rock County, Nebraska(6,10)",*,3 or fewer,"Rock County, Nebraska",*,*,**,1381,31,149,NA,NA
NE,"Saline County, Nebraska",1492,705,787,31151,51738,51875,NA,NA,62917,41667,6427,857,6226,541,12653,1398,"Saline County, Nebraska(6,10)",79.5,12,"Saline County, Nebraska",49.8,8,stable,14282,31,151,49.8,79.5
NE,"Sarpy County, Nebraska",10684,4831,5853,31153,70543,71796,58210,NA,70507,56464,75886,5603,78430,5281,154316,10884,"Sarpy County, Nebraska(6,10)",65.1,81,"Sarpy County, Nebraska",49.9,62,stable,175692,31,153,49.9,65.1
NE,"Saunders County, Nebraska",2001,911,1090,31155,60854,60988,NA,NA,NA,41071,9715,720,9515,664,19230,1384,"Saunders County, Nebraska(6,10)",60.8,17,"Saunders County, Nebraska",46.2,13,stable,21016,31,155,46.2,60.8
NE,"Scotts Bluff County, Nebraska",4877,2163,2714,31157,45992,46575,NA,NA,47143,34688,14776,2704,16164,2443,30940,5147,"Scotts Bluff County, Nebraska(6,10)",45.9,22,"Scotts Bluff County, Nebraska",34.6,17,stable,36261,31,157,34.6,45.9
NE,"Seward County, Nebraska",1467,738,729,31159,59662,60210,NA,NA,51250,46806,8006,588,7718,420,15724,1008,"Seward County, Nebraska(6,10)",44.2,9,"Seward County, Nebraska",32.2,7,stable,17110,31,159,32.2,44.2
NE,"Sheridan County, Nebraska",857,426,431,31161,41985,42014,NA,26500,NA,NA,2185,372,2285,353,4470,725,"Sheridan County, Nebraska(6,10)",42.2,4,"Sheridan County, Nebraska",*,*,*,5220,31,161,NA,42.2
NE,"Sherman County, Nebraska",411,126,285,31163,46366,46220,NA,NA,NA,60938,1379,133,1430,107,2809,240,"Sherman County, Nebraska(6,10)",*,3 or fewer,"Sherman County, Nebraska",66.1,3,**,3091,31,163,66.1,NA
NE,"Sioux County, Nebraska",156,64,92,31165,41215,40799,NA,NA,NA,NA,574,77,549,49,1123,126,"Sioux County, Nebraska(6,10)",*,3 or fewer,"Sioux County, Nebraska",*,*,**,1260,31,165,NA,NA
NE,"Stanton County, Nebraska",701,298,403,31167,53416,53198,NA,NA,NA,60455,2751,281,2725,310,5476,591,"Stanton County, Nebraska(6,10)",*,3 or fewer,"Stanton County, Nebraska",*,*,**,5937,31,167,NA,NA
NE,"Thayer County, Nebraska",604,298,306,31169,45741,45998,NA,NA,NA,NA,2339,159,2405,125,4744,284,"Thayer County, Nebraska(6,10)",57.9,5,"Thayer County, Nebraska",*,*,*,5163,31,169,NA,57.9
NE,"Thomas County, Nebraska",55,24,31,31171,51000,50600,NA,NA,NA,NA,315,41,297,22,612,63,"Thomas County, Nebraska(6,10)",*,3 or fewer,"Thomas County, Nebraska",*,*,**,684,31,171,NA,NA
NE,"Thurston County, Nebraska",2090,947,1143,31173,41266,53125,NA,32536,NA,24167,2351,1050,2548,941,4899,1991,"Thurston County, Nebraska(6,10)",65.1,4,"Thurston County, Nebraska",55.8,4,**,7064,31,173,55.8,65.1
NE,"Valley County, Nebraska",540,251,289,31175,44612,45147,NA,NA,NA,NA,1869,232,1919,190,3788,422,"Valley County, Nebraska(6,10)",*,3 or fewer,"Valley County, Nebraska",*,*,**,4154,31,175,NA,NA
NE,"Washington County, Nebraska",1880,595,1285,31177,65370,65621,NA,NA,NA,39679,9329,588,9285,867,18614,1455,"Washington County, Nebraska(6,10)",43.1,11,"Washington County, Nebraska",40.4,10,stable,20248,31,177,40.4,43.1
NE,"Wayne County, Nebraska",1115,644,471,31179,54159,59769,12276,NA,NA,NA,4472,365,4203,345,8675,710,"Wayne County, Nebraska(6,10)",29.3,3,"Wayne County, Nebraska",*,*,**,9367,31,179,NA,29.3
NE,"Webster County, Nebraska",459,235,224,31181,40256,40577,NA,NA,NA,35139,1593,163,1667,187,3260,350,"Webster County, Nebraska(6,10)",68.8,5,"Webster County, Nebraska",45.9,3,**,3625,31,181,45.9,68.8
NE,"Wheeler County, Nebraska",61,30,31,31183,46394,46394,NA,NA,NA,NA,399,33,375,40,774,73,"Wheeler County, Nebraska(6,10)",*,3 or fewer,"Wheeler County, Nebraska",*,*,**,750,31,183,NA,NA
NE,"York County, Nebraska",1393,621,772,31185,51802,52662,NA,NA,NA,NA,6087,621,6010,538,12097,1159,"York County, Nebraska(6,10)",36.8,7,"York County, Nebraska",28.2,5,falling,13806,31,185,28.2,36.8
NH,"Belknap County, New Hampshire",6214,2893,3321,33001,62159,62336,100972,NA,NA,65132,25364,3734,27430,3127,52794,6861,"Belknap County, New Hampshire(6,10)",65.6,56,"Belknap County, New Hampshire",55.2,46,stable,60641,33,1,55.2,65.6
NH,"Carroll County, New Hampshire",4484,2015,2469,33003,53306,53364,NA,70368,NA,52266,19928,3653,20392,3124,40320,6777,"Carroll County, New Hampshire(6,10)",65.8,53,"Carroll County, New Hampshire",42.9,35,falling,47285,33,3,42.9,65.8
NH,"Cheshire County, New Hampshire",8467,3684,4783,33005,57782,57817,NA,20000,65000,31458,32472,4282,35847,3084,68319,7366,"Cheshire County, New Hampshire(6,10)",66.6,63,"Cheshire County, New Hampshire",45.4,43,stable,75909,33,5,45.4,66.6
NH,"Coos County, New Hampshire",4257,1950,2307,33007,42312,42417,NA,51250,NA,23021,13183,1853,13622,1713,26805,3566,"Coos County, New Hampshire(6,10)",69.9,36,"Coos County, New Hampshire",54.8,27,falling,31212,33,7,54.8,69.9
NH,"Grafton County, New Hampshire",9609,4252,5357,33009,55762,56169,NA,47734,62976,NA,38402,5228,40032,4836,78434,10064,"Grafton County, New Hampshire(6,10)",56.4,65,"Grafton County, New Hampshire",38.6,44,falling,89320,33,9,38.6,56.4
NH,"Hillsborough County, New Hampshire",34681,15707,18974,33011,71244,71644,47284,32417,100375,42753,178942,19692,185709,15685,364651,35377,"Hillsborough County, New Hampshire(6,10)",66.2,283,"Hillsborough County, New Hampshire",46.1,194,falling,406678,33,11,46.1,66.2
NH,"Merrimack County, New Hampshire",12840,5578,7262,33013,65983,66113,53750,29196,70606,83512,63596,6756,68239,5583,131835,12339,"Merrimack County, New Hampshire(6,10)",66.9,118,"Merrimack County, New Hampshire",46.6,84,falling,147994,33,13,46.6,66.9
NH,"Rockingham County, New Hampshire",16192,7315,8877,33015,81198,81718,74453,57016,83531,70223,134871,11591,140369,10100,275240,21691,"Rockingham County, New Hampshire(6,10)",72.5,242,"Rockingham County, New Hampshire",49.4,163,falling,301777,33,15,49.4,72.5
NH,"Strafford County, New Hampshire",12997,5717,7280,33017,60711,61054,37063,28980,58287,58080,53304,6948,57377,6285,110681,13233,"Strafford County, New Hampshire(6,10)",75,96,"Strafford County, New Hampshire",53.3,68,falling,126825,33,17,53.3,75
NH,"Sullivan County, New Hampshire",4099,1959,2140,33019,56032,56113,101563,50912,80640,75294,18333,2630,19593,2148,37926,4778,"Sullivan County, New Hampshire(6,10)",72.6,44,"Sullivan County, New Hampshire",51.7,32,stable,42967,33,19,51.7,72.6
NJ,"Atlantic County, New Jersey",40868,18753,22115,34001,54461,60848,33060,NA,54271,41392,112340,19078,124944,16097,237284,35175,"Atlantic County, New Jersey(7,8)",69.9,230,"Atlantic County, New Jersey",47.9,156,falling,274219,34,1,47.9,69.9
NJ,"Bergen County, New Jersey",67959,29262,38697,34003,85806,88041,66075,41925,96776,63194,391824,53563,426933,48157,818757,101720,"Bergen County, New Jersey(7,8)",50.9,580,"Bergen County, New Jersey",34.7,402,falling,938506,34,3,34.7,50.9
NJ,"Burlington County, New Jersey",27881,12238,15643,34005,78621,81262,65759,66944,106429,66202,192963,16726,213627,12770,406590,29496,"Burlington County, New Jersey(7,8)",65.1,342,"Burlington County, New Jersey",44.2,232,falling,450226,34,5,44.2,65.1
NJ,"Camden County, New Jersey",66802,28813,37989,34007,62185,71426,41664,30750,77749,37766,212875,31229,239130,23082,452005,54311,"Camden County, New Jersey(7,8)",71.9,406,"Camden County, New Jersey",48.9,275,falling,510923,34,7,48.9,71.9
NJ,"Cape May County, New Jersey",9744,4179,5565,34009,57637,58911,39439,70313,NA,37813,40486,4651,44888,3602,85374,8253,"Cape May County, New Jersey(7,8)",83.5,136,"Cape May County, New Jersey",54.9,90,falling,94727,34,9,54.9,83.5
NJ,"Cumberland County, New Jersey",25760,11633,14127,34011,49984,54392,41547,40625,52778,38793,59423,10828,66601,8609,126024,19437,"Cumberland County, New Jersey(7,8)",73.4,122,"Cumberland County, New Jersey",50.7,84,falling,155854,34,11,50.7,73.4
NJ,"Essex County, New Jersey",133788,57543,76245,34013,53976,80333,37254,32631,105597,41603,303430,68533,350254,57907,653684,126440,"Essex County, New Jersey(7,8)",50.9,399,"Essex County, New Jersey",37.1,289,falling,797434,34,13,37.1,50.9
NJ,"Gloucester County, New Jersey",23200,9915,13285,34015,76727,80139,57980,46427,105435,51147,128535,11903,138803,9679,267338,21582,"Gloucester County, New Jersey(7,8)",80.5,250,"Gloucester County, New Jersey",55.5,172,falling,291479,34,15,55.5,80.5
NJ,"Hudson County, New Jersey",114900,50273,64627,34017,59741,61384,42537,42708,94360,42715,258423,69020,272486,59125,530909,128145,"Hudson County, New Jersey(7,8)",48.8,279,"Hudson County, New Jersey",36.5,206,falling,674836,34,17,36.5,48.8
NJ,"Hunterdon County, New Jersey",5379,2236,3143,34019,105444,106046,88047,NA,128611,61058,56714,3170,60109,2305,116823,5475,"Hunterdon County, New Jersey(7,8)",54.4,80,"Hunterdon County, New Jersey",37.8,55,falling,125488,34,19,37.8,54.4
NJ,"Mercer County, New Jersey",40354,18218,22136,34021,72804,82536,42170,26384,130621,46585,154154,21815,171281,15938,325435,37753,"Mercer County, New Jersey(7,8)",59.1,235,"Mercer County, New Jersey",38.2,152,falling,371398,34,21,38.2,59.1
NJ,"Middlesex County, New Jersey",70908,31792,39116,34023,79593,73145,64822,66713,111242,54324,350206,51055,376132,43310,726338,94365,"Middlesex County, New Jersey(7,8)",53.4,459,"Middlesex County, New Jersey",37,319,falling,840900,34,23,37,53.4
NJ,"Monmouth County, New Jersey",46492,20092,26400,34025,85242,89948,44668,28346,117334,54291,273118,31154,295155,25547,568273,56701,"Monmouth County, New Jersey(7,8)",63.9,475,"Monmouth County, New Jersey",42.8,317,falling,628715,34,25,42.8,63.9
NJ,"Morris County, New Jersey",22068,9710,12358,34027,100214,100722,77681,73750,121340,67771,222190,19830,235146,17038,457336,36868,"Morris County, New Jersey(7,8)",49.6,287,"Morris County, New Jersey",34.8,201,falling,499509,34,27,34.8,49.6
NJ,"Ocean County, New Jersey",64795,29231,35564,34029,61994,62147,53237,25474,90000,54902,251605,26431,277128,22954,528733,49385,"Ocean County, New Jersey(7,8)",71.4,645,"Ocean County, New Jersey",47.7,442,falling,588721,34,29,47.7,71.4
NJ,"Passaic County, New Jersey",83203,37009,46194,34031,59739,72024,33682,51691,94406,40260,199460,45684,221524,37168,420984,82852,"Passaic County, New Jersey(7,8)",53.8,276,"Passaic County, New Jersey",39.3,202,falling,510916,34,31,39.3,53.8
NJ,"Salem County, New Jersey",8602,3826,4776,34033,61831,67079,32740,22083,82500,46838,27515,3442,30248,2723,57763,6165,"Salem County, New Jersey(7,8)",72.8,62,"Salem County, New Jersey",48.1,41,falling,64180,34,33,48.1,72.8
NJ,"Somerset County, New Jersey",16479,7340,9139,34035,100667,99241,76791,45729,141242,70111,145888,13951,155658,12324,301546,26275,"Somerset County, New Jersey(7,8)",48.7,171,"Somerset County, New Jersey",35.3,122,falling,333654,34,35,35.3,48.7
NJ,"Sussex County, New Jersey",8237,3862,4375,34037,86565,85990,95813,110469,116856,77520,65217,6547,67862,4954,133079,11501,"Sussex County, New Jersey(7,8)",64.2,106,"Sussex County, New Jersey",45.2,74,falling,143673,34,37,45.2,64.2
NJ,"Union County, New Jersey",59034,24322,34712,34039,69594,81376,53858,25652,114138,50100,220599,44217,241572,37837,462171,82054,"Union County, New Jersey(7,8)",47.9,274,"Union County, New Jersey",35.8,207,falling,555786,34,39,35.8,47.9
NJ,"Warren County, New Jersey",8394,3681,4713,34041,70471,71885,71548,30409,62639,51948,46651,4979,50057,4518,96708,9497,"Warren County, New Jersey(7,8)",65.4,85,"Warren County, New Jersey",45.6,59,falling,106869,34,41,45.6,65.4
NM,"Bernalillo County, New Mexico",128917,59967,68950,35001,47725,51836,32761,32872,60831,38967,272940,52028,296915,44601,569855,96629,"Bernalillo County, New Mexico(7,8)",39.4,277,"Bernalillo County, New Mexico",31.2,216,falling,676685,35,1,31.2,39.4
NM,"Catron County, New Mexico",615,177,438,35003,42973,43092,NA,NA,NA,27132,1528,367,1451,228,2979,595,"Catron County, New Mexico(7)",41.2,4,"Catron County, New Mexico",*,*,**,3456,35,3,NA,41.2
NM,"Chaves County, New Mexico",14013,6312,7701,35005,40630,42455,30256,35536,58799,34665,26078,5891,27592,5260,53670,11151,"Chaves County, New Mexico(7,8)",47.5,36,"Chaves County, New Mexico",40.9,31,stable,65764,35,5,40.9,47.5
NM,"Cibola County, New Mexico",7489,3567,3922,35006,34565,42707,45893,27478,NA,35616,9819,2968,10636,2213,20455,5181,"Cibola County, New Mexico(7,8)",50.6,15,"Cibola County, New Mexico",24.7,7,stable,27329,35,6,24.7,50.6
NM,"Colfax County, New Mexico",2490,1121,1369,35007,32380,35025,NA,4558,NA,28608,5246,879,5714,702,10960,1581,"Colfax County, New Mexico(7,8)",38.1,9,"Colfax County, New Mexico",25.3,6,falling,12414,35,7,25.3,38.1
NM,"Curry County, New Mexico",10338,4527,5811,35009,41084,46239,29976,30000,38988,31586,19743,4372,20736,3137,40479,7509,"Curry County, New Mexico(7,8)",46.8,21,"Curry County, New Mexico",36.7,17,stable,50398,35,9,36.7,46.8
NM,"De Baca County, New Mexico",454,227,227,35011,32500,36528,NA,NA,NA,25577,751,141,1002,101,1753,242,"DeBaca County, New Mexico(7)",*,3 or fewer,"DeBaca County, New Mexico",*,*,**,1828,35,11,NA,NA
NM,"Doña Ana County, New Mexico",58846,27487,31359,35013,38853,39110,50718,33913,41006,30930,83656,18726,90314,17907,173970,36633,"Dona Ana County, New Mexico(7,8)",42.6,92,"Dona Ana County, New Mexico",33.8,72,falling,214295,35,13,33.8,42.6
NM,"Eddy County, New Mexico",6237,2460,3777,35015,56618,57248,61544,70714,97554,47952,23842,4068,23388,3791,47230,7859,"Eddy County, New Mexico(7,8)",47.3,29,"Eddy County, New Mexico",38.3,24,falling,57578,35,15,38.3,47.3
NM,"Grant County, New Mexico",5940,2771,3169,35017,38311,38832,NA,15161,NA,31556,12900,1315,13334,1189,26234,2504,"Grant County, New Mexico(7,8)",44.7,22,"Grant County, New Mexico",30,15,falling,28609,35,17,30,44.7
NM,"Guadalupe County, New Mexico",552,239,313,35019,30772,31745,5250,36250,NA,30980,1815,209,1748,150,3563,359,"Guadalupe County, New Mexico(7)",*,3 or fewer,"Guadalupe County, New Mexico",*,*,**,4371,35,19,NA,NA
NM,"Harding County, New Mexico",59,29,30,35021,33393,34107,NA,NA,NA,33500,274,17,246,27,520,44,"Harding County, New Mexico(7)",*,3 or fewer,"Harding County, New Mexico",*,*,**,698,35,21,NA,NA
NM,"Hidalgo County, New Mexico",1054,443,611,35023,34444,35714,NA,NA,NA,31698,1879,352,1862,430,3741,782,"Hidalgo County, New Mexico(7)",*,3 or fewer,"Hidalgo County, New Mexico",*,*,**,4423,35,23,NA,NA
NM,"Lea County, New Mexico",9859,3934,5925,35025,57533,59273,40060,70724,NA,51966,27173,6335,26439,6606,53612,12941,"Lea County, New Mexico(7,8)",57.7,34,"Lea County, New Mexico",40.8,24,falling,71180,35,25,40.8,57.7
NM,"Lincoln County, New Mexico",3271,1479,1792,35027,40708,42235,NA,40426,NA,28870,8397,1373,8737,1283,17134,2656,"Lincoln County, New Mexico(7,8)",45.4,17,"Lincoln County, New Mexico",31.9,11,stable,19420,35,27,31.9,45.4
NM,"Los Alamos County, New Mexico",1092,429,663,35028,101934,102965,NA,135089,100357,44844,8611,523,8183,510,16794,1033,"Los Alamos County, New Mexico(7,8)",26.5,7,"Los Alamos County, New Mexico",15.8,4,stable,17785,35,28,15.8,26.5
NM,"Luna County, New Mexico",7236,3080,4156,35029,27476,27561,NA,NA,NA,25568,9539,2561,10103,2219,19642,4780,"Luna County, New Mexico(7,8)",56.8,22,"Luna County, New Mexico",41,15,stable,24518,35,29,41,56.8
NM,"McKinley County, New Mexico",27493,13235,14258,35031,28772,50612,NA,23695,57917,39288,23399,12014,26997,11227,50396,23241,"McKinley County, New Mexico(7,8)",13.5,9,"McKinley County, New Mexico",11.6,7,falling,76708,35,31,11.6,13.5
NM,"Mora County, New Mexico",1092,669,423,35033,23822,26563,NA,NA,NA,23132,1699,527,2067,367,3766,894,"Mora County, New Mexico(7)",*,3 or fewer,"Mora County, New Mexico",*,*,**,4596,35,33,NA,NA
NM,"Otero County, New Mexico",14387,6638,7749,35035,39775,42728,36168,28958,37986,25018,24419,4996,26535,4567,50954,9563,"Otero County, New Mexico(7,8)",58.5,45,"Otero County, New Mexico",43.2,33,stable,64362,35,35,43.2,58.5
NM,"Quay County, New Mexico",1484,640,844,35037,29113,29677,19000,NA,NA,27298,3576,613,4109,365,7685,978,"Quay County, New Mexico(7,8)",62.1,9,"Quay County, New Mexico",51.2,7,stable,8455,35,37,51.2,62.1
NM,"Rio Arriba County, New Mexico",9413,4770,4643,35039,36098,35374,38750,32195,71169,37923,15072,4355,16670,3586,31742,7941,"Rio Arriba County, New Mexico(7,8)",34.8,16,"Rio Arriba County, New Mexico",30.3,14,stable,39465,35,39,30.3,34.8
NM,"Roosevelt County, New Mexico",4918,2164,2754,35041,35546,36484,18417,NA,NA,29611,7984,1736,8234,1470,16218,3206,"Roosevelt County, New Mexico(7,8)",55.2,10,"Roosevelt County, New Mexico",37.2,7,stable,19120,35,41,37.2,55.2
NM,"Sandoval County, New Mexico",19305,8939,10366,35043,58982,61358,71012,39332,66307,56246,57383,9182,61538,7749,118921,16931,"Sandoval County, New Mexico(7,8)",40.4,58,"Sandoval County, New Mexico",30.9,42,falling,139394,35,43,30.9,40.4
NM,"San Juan County, New Mexico",24755,11972,12783,35045,48671,55802,NA,34862,56500,48734,46708,14508,50124,12443,96832,26951,"San Juan County, New Mexico(7,8)",44,53,"San Juan County, New Mexico",30.1,36,falling,118737,35,45,30.1,44
NM,"San Miguel County, New Mexico",8093,3544,4549,35047,29237,36446,NA,NA,NA,28367,11235,2535,11977,2358,23212,4893,"San Miguel County, New Mexico(7,8)",37.3,14,"San Miguel County, New Mexico",34.4,12,stable,27967,35,47,34.4,37.3
NM,"Santa Fe County, New Mexico",22477,10373,12104,35049,54315,56387,47440,42159,59716,43876,56164,13908,63236,11977,119400,25885,"Santa Fe County, New Mexico(7,8)",31.7,59,"Santa Fe County, New Mexico",23,42,falling,148686,35,49,23,31.7
NM,"Sierra County, New Mexico",2360,1347,1013,35051,29356,30806,NA,27105,NA,28273,4718,973,5002,681,9720,1654,"Sierra County, New Mexico(7,8)",55.1,16,"Sierra County, New Mexico",49,14,stable,11282,35,51,49,55.1
NM,"Socorro County, New Mexico",4278,1928,2350,35053,34037,34868,NA,16319,122083,28714,7482,1584,7246,1080,14728,2664,"Socorro County, New Mexico(7,8)",47.8,10,"Socorro County, New Mexico",35.9,7,stable,17256,35,53,35.9,47.8
NM,"Taos County, New Mexico",7909,3785,4124,35055,36582,40359,NA,31632,NA,31585,13285,2640,14135,2679,27420,5319,"Taos County, New Mexico(7,8)",35,16,"Taos County, New Mexico",27.5,13,stable,32907,35,55,27.5,35
NM,"Torrance County, New Mexico",4833,2325,2508,35057,32083,32880,NA,9323,NA,31069,5959,1566,6662,909,12621,2475,"Torrance County, New Mexico(7,8)",49,11,"Torrance County, New Mexico",40.4,9,stable,15485,35,57,40.4,49
NM,"Union County, New Mexico",498,176,322,35059,36070,36726,NA,NA,NA,28889,1427,400,1549,346,2976,746,"Union County, New Mexico(7,8)",*,3 or fewer,"Union County, New Mexico",*,*,**,4201,35,59,NA,NA
NM,"Valencia County, New Mexico",17604,8399,9205,35061,41703,43699,43244,42500,72625,34760,30560,6254,33613,4273,64173,10527,"Valencia County, New Mexico(7,8)",50.8,42,"Valencia County, New Mexico",41.9,34,stable,75737,35,61,41.9,50.8
NV,"Churchill County, Nevada",3802,1765,2037,32001,47415,48172,50057,55250,45417,35568,9756,1871,9845,1873,19601,3744,"Churchill County, Nevada(6)",__,__,"Churchill County, Nevada",59.9,18,stable,24200,32,1,59.9,NA
NV,"Clark County, Nevada",315358,147575,167783,32003,51575,54767,37604,44759,60857,43244,799278,201993,830625,180211,1629903,382204,"Clark County, Nevada(6)",__,__,"Clark County, Nevada",48.1,901,falling,2114801,32,3,48.1,NA
NV,"Douglas County, Nevada",4984,2264,2720,32005,58535,59891,61083,26950,48553,40714,19911,3602,20431,2952,40342,6554,"Douglas County, Nevada(6)",__,__,"Douglas County, Nevada",40.9,32,stable,47710,32,5,40.9,NA
NV,"Elko County, Nevada",5574,2675,2899,32007,71799,73428,NA,43472,55714,50925,22496,3962,20493,3991,42989,7953,"Elko County, Nevada(6)",__,__,"Elko County, Nevada",39.9,15,stable,51935,32,7,39.9,NA
NV,"Esmeralda County, Nevada",194,53,141,32009,39271,42125,NA,NA,NA,NA,387,128,475,146,862,274,"Esmeralda County, Nevada(6)",__,__,"Esmeralda County, Nevada",*,*,**,829,32,9,NA,NA
NV,"Eureka County, Nevada",162,106,56,32011,60250,60667,NA,NA,NA,NA,652,140,732,140,1384,280,"Eureka County, Nevada(6)",__,__,"Eureka County, Nevada",*,*,**,2016,32,11,NA,NA
NV,"Humboldt County, Nevada",1762,802,960,32013,65212,65508,NA,NA,NA,65828,7339,1429,6497,1574,13836,3003,"Humboldt County, Nevada(6)",__,__,"Humboldt County, Nevada",48.4,7,stable,17019,32,13,48.4,NA
NV,"Lander County, Nevada",676,349,327,32015,78190,79138,NA,NA,NA,89750,2775,447,2096,590,4871,1037,"Lander County, Nevada(6)",__,__,"Lander County, Nevada",*,*,**,5903,32,15,NA,NA
NV,"Lincoln County, Nevada",631,372,259,32017,44866,44717,NA,45260,NA,NA,2095,415,1919,390,4014,805,"Lincoln County, Nevada(6)",__,__,"Lincoln County, Nevada",*,*,**,5036,32,17,NA,NA
NV,"Lyon County, Nevada",8482,3749,4733,32019,47255,47817,66607,45747,47794,40012,21106,4645,21605,3982,42711,8627,"Lyon County, Nevada(6)",__,__,"Lyon County, Nevada",61.2,41,stable,52585,32,19,61.2,NA
NV,"Mineral County, Nevada",907,429,478,32021,38923,48143,NA,30167,NA,64554,1926,446,1816,296,3742,742,"Mineral County, Nevada(6)",__,__,"Mineral County, Nevada",63.6,5,stable,4478,32,21,63.6,NA
NV,"Nye County, Nevada",7658,3541,4117,32023,41712,42575,42656,21250,NA,35327,17457,3427,17963,3405,35420,6832,"Nye County, Nevada(6)",__,__,"Nye County, Nevada",67.9,52,stable,42477,32,23,67.9,NA
NV,"Pershing County, Nevada",832,350,482,32027,45230,46528,NA,NA,NA,41071,1995,525,1846,413,3841,938,"Pershing County, Nevada(6)",__,__,"Pershing County, Nevada",61,4,**,6634,32,27,61,NA
NV,"Storey County, Nevada",293,134,159,32029,64832,66161,NA,18438,NA,NA,1493,376,1826,210,3319,586,"Storey County, Nevada(6)",__,__,"Storey County, Nevada",*,*,**,3987,32,29,NA,NA
NV,"Washoe County, Nevada",65248,30454,34794,32031,52870,54480,30773,42183,56760,41422,176960,39625,183055,32403,360015,72028,"Washoe County, Nevada(6)",__,__,"Washoe County, Nevada",41.7,182,falling,446903,32,31,41.7,NA
NV,"White Pine County, Nevada",987,381,606,32033,57122,58096,NA,52548,NA,68333,3873,526,3532,731,7405,1257,"White Pine County, Nevada(6)",__,__,"White Pine County, Nevada",46.1,6,**,9811,32,33,46.1,NA
NV,"Carson City, Nevada",8787,3992,4795,32510,47668,47882,93036,30708,74458,43972,21461,4907,22411,3802,43872,8709,"Carson City, Nevada(6)",__,__,"Carson City, Nevada",51.8,39,falling,54521,32,510,51.8,NA
NY,"Albany County, New York",39349,17368,21981,36001,59887,65120,32328,32083,60174,32917,136092,11096,149544,7079,285636,18175,"Albany County, New York(6,10)",73,258,"Albany County, New York",51.2,181,falling,309381,36,1,51.2,73
NY,"Allegany County, New York",7285,3424,3861,36003,42776,43010,40625,31313,29250,18333,21718,2411,21566,1902,43284,4313,"Allegany County, New York(6,10)",76.9,46,"Allegany County, New York",50.7,30,stable,47462,36,3,50.7,76.9
NY,"Bronx County, New York",427574,181112,246462,36005,34299,41539,36712,29889,47819,27906,546151,112171,667792,79977,1213943,192148,"Bronx County, New York(6,10)",50.4,641,"Bronx County, New York",34.5,438,falling,1455444,36,5,34.5,50.4
NY,"Broome County, New York",33615,15839,17776,36007,46261,48347,21355,26042,38906,25137,87879,8190,93618,5438,181497,13628,"Broome County, New York(6,10)",61.7,160,"Broome County, New York",42.1,111,falling,196567,36,7,42.1,61.7
NY,"Cattaraugus County, New York",13954,6444,7510,36009,42601,43225,58194,30379,49688,37292,34324,4389,35911,3604,70235,7993,"Cattaraugus County, New York(6,10)",75.8,77,"Cattaraugus County, New York",50.9,52,falling,77922,36,9,50.9,75.8
NY,"Cayuga County, New York",9010,4089,4921,36011,52082,52488,50000,37000,48304,41250,34015,3875,35593,2514,69608,6389,"Cayuga County, New York(6,10)",77.7,79,"Cayuga County, New York",49.5,51,stable,78288,36,11,49.5,77.7
NY,"Chautauqua County, New York",23894,10816,13078,36013,42993,43717,20513,14083,25781,23974,58267,5797,61793,4155,120060,9952,"Chautauqua County, New York(6,10)",67.9,122,"Chautauqua County, New York",49.4,90,stable,130779,36,13,49.4,67.9
NY,"Chemung County, New York",13044,5401,7643,36015,50320,51240,23077,28788,84438,25938,37175,2867,41183,2753,78358,5620,"Chemung County, New York(6,10)",77,88,"Chemung County, New York",56.2,66,stable,87071,36,15,56.2,77
NY,"Chenango County, New York",7741,3403,4338,36017,45668,45701,NA,NA,82813,51471,21882,2543,22703,1852,44585,4395,"Chenango County, New York(6,10)",71.9,49,"Chenango County, New York",52.1,35,stable,48844,36,17,52.1,71.9
NY,"Clinton County, New York",12163,5245,6918,36019,49930,50548,40231,NA,33333,27059,35166,2815,37281,1930,72447,4745,"Clinton County, New York(6,10)",95.1,90,"Clinton County, New York",53.9,50,stable,81251,36,19,53.9,95.1
NY,"Columbia County, New York",7067,3251,3816,36021,59105,61370,31579,NA,43472,36652,27711,2424,28700,1636,56411,4060,"Columbia County, New York(6,10)",79,74,"Columbia County, New York",55.7,52,stable,61509,36,21,55.7,79
NY,"Cortland County, New York",6675,2638,4037,36023,49514,50037,22375,NA,NA,40968,21754,1994,23643,1182,45397,3176,"Cortland County, New York(6,10)",79,43,"Cortland County, New York",59.1,32,stable,48494,36,23,59.1,79
NY,"Delaware County, New York",6799,3306,3493,36025,43720,43757,NA,NA,34323,39542,21050,2238,21095,1983,42145,4221,"Delaware County, New York(6,10)",68.9,51,"Delaware County, New York",46.3,34,stable,46053,36,25,46.3,68.9
NY,"Dutchess County, New York",26229,11831,14398,36027,71904,74963,44829,31979,100797,53392,128932,12845,138223,9320,267155,22165,"Dutchess County, New York(6,10)",64.7,226,"Dutchess County, New York",44,151,falling,295754,36,27,44,64.7
NY,"Erie County, New York",134715,59086,75629,36029,51247,57499,25819,31056,46587,26909,407808,30636,449962,21593,857770,52229,"Erie County, New York(6,10)",76.2,886,"Erie County, New York",52.6,620,stable,922578,36,29,52.6,76.2
NY,"Essex County, New York",3894,1756,2138,36031,52758,52982,2499,17917,41250,NA,16571,1724,17184,1210,33755,2934,"Essex County, New York(6,10)",68,40,"Essex County, New York",46.7,28,falling,38478,36,31,46.7,68
NY,"Franklin County, New York",9213,4383,4830,36033,47923,48314,NA,34674,NA,110652,20904,2679,20771,2095,41675,4774,"Franklin County, New York(6,10)",77.9,46,"Franklin County, New York",56.4,33,falling,50660,36,33,56.4,77.9
NY,"Fulton County, New York",9100,4176,4924,36035,46969,47583,NA,48696,42167,NA,23688,2953,25023,2103,48711,5056,"Fulton County, New York(6,10)",80,58,"Fulton County, New York",47.6,35,falling,53992,36,35,47.6,80
NY,"Genesee County, New York",7748,3521,4227,36037,50880,52032,14661,35859,NA,31962,26500,2833,27875,1715,54375,4548,"Genesee County, New York(6,10)",80.4,61,"Genesee County, New York",58.2,45,stable,58937,36,37,58.2,80.4
NY,"Greene County, New York",5813,2342,3471,36039,50278,50700,38516,65625,93851,38152,20501,1739,21459,1697,41960,3436,"Greene County, New York(6,10)",72.7,51,"Greene County, New York",54.1,38,falling,47625,36,39,54.1,72.7
NY,"Hamilton County, New York",609,317,292,36041,48243,48885,NA,NA,NA,NA,2029,353,2217,137,4246,490,"Hamilton County, New York(6,10)",78.4,7,"Hamilton County, New York",57.6,5,stable,4712,36,41,57.6,78.4
NY,"Herkimer County, New York",9145,4089,5056,36043,46229,46545,NA,38000,NA,NA,27782,3525,30157,1908,57939,5433,"Herkimer County, New York(6,10)",71.1,63,"Herkimer County, New York",44.2,39,falling,63100,36,43,44.2,71.1
NY,"Jefferson County, New York",16938,7850,9088,36045,49505,50171,48918,44192,52813,40511,45675,4905,52114,3727,97789,8632,"Jefferson County, New York(6,10)",79.6,88,"Jefferson County, New York",50.4,56,stable,117635,36,45,50.4,79.6
NY,"Kings County, New York",597404,265335,332069,36047,48201,58330,41053,28333,50761,36466,1049003,174172,1225395,136478,2274398,310650,"Kings County, New York(6,10)",49.3,1218,"Kings County, New York",33.4,824,stable,2636735,36,47,33.4,49.3
NY,"Lewis County, New York",3238,1478,1760,36049,49819,50447,23690,NA,62500,45795,12000,1526,12111,1135,24111,2661,"Lewis County, New York(6,10)",62.7,22,"Lewis County, New York",51.8,18,stable,26957,36,49,51.8,62.7
NY,"Livingston County, New York",8681,3775,4906,36051,51734,52317,19174,44167,NA,26116,28323,2011,30406,1597,58729,3608,"Livingston County, New York(6,10)",67.2,52,"Livingston County, New York",45.8,36,falling,64717,36,51,45.8,67.2
NY,"Madison County, New York",8180,3640,4540,36053,54145,54261,NA,36442,81806,49779,32642,2656,35019,1471,67661,4127,"Madison County, New York(6,10)",79.9,69,"Madison County, New York",56.2,49,stable,71849,36,53,56.2,79.9
NY,"Monroe County, New York",110192,48774,61418,36055,52553,59131,26950,23293,54429,29340,332340,26459,364808,18562,697148,45021,"Monroe County, New York(6,10)",65.2,569,"Monroe County, New York",46.4,405,falling,749600,36,55,46.4,65.2
NY,"Montgomery County, New York",10053,4433,5620,36057,43764,45668,37534,57917,30982,24149,21624,2545,23046,1810,44670,4355,"Montgomery County, New York(6,10)",81.1,53,"Montgomery County, New York",50.7,34,falling,49642,36,57,50.7,81.1
NY,"Nassau County, New York",82146,35207,46939,36059,99465,103536,82121,41648,118893,72728,595139,56534,648611,44182,1243750,100716,"Nassau County, New York(6,10)",58.4,992,"Nassau County, New York",34.8,605,falling,1361350,36,59,34.8,58.4
NY,"New York County, New York",283590,123922,159668,36061,72871,100221,32787,31056,70702,33044,681115,82373,793398,61737,1474513,144110,"New York County, New York(6,10)",50.4,892,"New York County, New York",32.2,573,falling,1644518,36,61,32.2,50.4
NY,"Niagara County, New York",28816,12569,16247,36063,49449,52411,24420,33529,37708,30986,95704,7556,103074,5711,198778,13267,"Niagara County, New York(6,10)",80.1,227,"Niagara County, New York",56.3,159,falling,212652,36,63,56.3,80.1
NY,"Oneida County, New York",37760,17386,20374,36065,48246,50770,25648,16204,36607,21486,101852,8753,109110,6067,210962,14820,"Oneida County, New York(6,10)",79.9,245,"Oneida County, New York",53,164,stable,232500,36,65,53,79.9
NY,"Onondaga County, New York",69487,31279,38208,36067,55092,60251,28516,42207,44679,34088,205440,17840,226524,13226,431964,31066,"Onondaga County, New York(6,10)",78.2,432,"Onondaga County, New York",52.4,289,falling,468463,36,67,52.4,78.2
NY,"Ontario County, New York",10975,4935,6040,36069,57416,58530,29933,45673,NA,32500,48533,4413,52278,2959,100811,7372,"Ontario County, New York(6,10)",72.6,102,"Ontario County, New York",48.3,67,falling,109561,36,69,48.3,72.6
NY,"Orange County, New York",46731,21428,25303,36071,70848,74883,61972,75568,105750,59298,163553,16726,173191,12204,336744,28930,"Orange County, New York(6,10)",67.8,248,"Orange County, New York",46.5,167,falling,377647,36,71,46.5,67.8
NY,"Orleans County, New York",6173,2836,3337,36073,46359,46709,35764,71136,NA,29167,17756,1951,18283,1388,36039,3339,"Orleans County, New York(6,10)",89.8,47,"Orleans County, New York",65.4,34,stable,41582,36,73,65.4,89.8
NY,"Oswego County, New York",21615,10192,11423,36075,47860,48307,NA,NA,47969,33371,54654,5561,56407,3777,111061,9338,"Oswego County, New York(6,10)",92.6,126,"Oswego County, New York",65.9,88,stable,120146,36,75,65.9,92.6
NY,"Otsego County, New York",9275,4372,4903,36077,48588,48730,NA,55417,71346,50625,26884,2673,29350,1834,56234,4507,"Otsego County, New York(6,10)",66.5,55,"Otsego County, New York",52,43,stable,60636,36,77,52,66.5
NY,"Putnam County, New York",5212,2693,2519,36079,96148,97347,85257,55072,125685,81429,45157,4059,46074,3540,91231,7599,"Putnam County, New York(6,10)",69,77,"Putnam County, New York",45.2,49,falling,99042,36,79,45.2,69
NY,"Queens County, New York",343834,148985,194849,36081,57720,60915,59062,48106,56151,50585,908912,199532,1019688,158193,1928600,357725,"Queens County, New York(6,10)",47.8,1161,"Queens County, New York",30.4,740,falling,2339150,36,81,30.4,47.8
NY,"Rensselaer County, New York",19186,8695,10491,36083,60709,63032,26620,NA,48438,40425,72733,5474,76458,3465,149191,8939,"Rensselaer County, New York(6,10)",84,157,"Rensselaer County, New York",58.4,109,falling,160266,36,83,58.4,84
NY,"Richmond County, New York",58470,26399,32071,36085,73197,78239,46455,56125,72381,56238,207045,19813,227781,13987,434826,33800,"Richmond County, New York(6,10)",66.4,344,"Richmond County, New York",45.6,233,falling,474558,36,85,45.6,66.4
NY,"Rockland County, New York",46118,21825,24293,36087,84855,87250,74939,69390,112984,58658,140580,15354,149776,12368,290356,27722,"Rockland County, New York(6,10)",50.2,177,"Rockland County, New York",32.9,116,falling,326037,36,87,32.9,50.2
NY,"St. Lawrence County, New York",19494,9391,10103,36089,44705,44857,68259,NA,43681,51827,47996,6068,50035,4289,98031,10357,"St. Lawrence County, New York(6,10)",82.4,108,"St. Lawrence County, New York",60.3,78,falling,111007,36,89,60.3,82.4
NY,"Saratoga County, New York",14583,6435,8148,36091,71496,71257,55250,NA,100134,71563,101757,6317,107942,4428,209699,10745,"Saratoga County, New York(6,10)",72.2,188,"Saratoga County, New York",52.4,135,falling,226249,36,91,52.4,72.2
NY,"Schenectady County, New York",19028,8584,10444,36093,58114,62266,27507,48182,63698,28836,68218,6160,74298,4396,142516,10556,"Schenectady County, New York(6,10)",70.9,135,"Schenectady County, New York",49.4,94,falling,154604,36,93,49.4,70.9
NY,"Schoharie County, New York",3936,1911,2025,36095,51195,50889,NA,NA,87891,58750,14353,1482,15212,754,29565,2236,"Schoharie County, New York(6,10)",65.1,29,"Schoharie County, New York",44.4,20,stable,31330,36,95,44.4,65.1
NY,"Schuyler County, New York",2595,1062,1533,36097,47680,47897,NA,42125,NA,52925,7916,1114,8390,669,16306,1783,"Schuyler County, New York(6,10)",70.3,18,"Schuyler County, New York",58.8,15,stable,18186,36,97,58.8,70.3
NY,"Seneca County, New York",4081,1817,2264,36099,49292,50237,21329,58472,NA,22685,14250,1859,14865,1491,29115,3350,"Seneca County, New York(6,10)",81.3,37,"Seneca County, New York",46.6,21,stable,34833,36,99,46.6,81.3
NY,"Steuben County, New York",15888,7157,8731,36101,47280,47089,37656,48214,97540,48036,43195,5104,45215,3995,88410,9099,"Steuben County, New York(6,10)",80,104,"Steuben County, New York",60,78,stable,97631,36,101,60,80
NY,"Suffolk County, New York",103269,45309,57960,36103,88663,91451,69805,53750,96420,74070,658711,72441,702061,52982,1360772,125423,"Suffolk County, New York(6,10)",69.7,1195,"Suffolk County, New York",43.8,751,falling,1501587,36,103,43.8,69.7
NY,"Sullivan County, New York",12868,6015,6853,36105,50710,52599,30252,60313,75125,39007,32306,4817,33861,3063,66167,7880,"Sullivan County, New York(6,10)",71.9,71,"Sullivan County, New York",51.6,51,falling,74877,36,105,51.6,71.9
NY,"Tioga County, New York",4801,2062,2739,36107,57514,57954,65313,NA,NA,53667,22472,2139,23751,1473,46223,3612,"Tioga County, New York(6,10)",64.4,44,"Tioga County, New York",46.2,31,falling,49453,36,107,46.2,64.4
NY,"Tompkins County, New York",18547,8362,10185,36109,52624,57433,26136,33264,24722,31069,47132,3403,50126,2334,97258,5737,"Tompkins County, New York(6,10)",57.6,54,"Tompkins County, New York",42.6,40,falling,104926,36,109,42.6,57.6
NY,"Ulster County, New York",22290,10453,11837,36111,58918,60842,35326,35050,54333,42773,77152,9528,83276,7023,160428,16551,"Ulster County, New York(6,10)",71.5,164,"Ulster County, New York",48.3,111,falling,180143,36,111,48.3,71.5
NY,"Warren County, New York",7685,3218,4467,36113,56798,57422,26500,43750,65313,50515,28599,3065,30686,2238,59285,5303,"Warren County, New York(6,10)",71.2,66,"Warren County, New York",45.8,42,stable,64688,36,113,45.8,71.2
NY,"Washington County, New York",8004,3581,4423,36115,51143,51109,NA,39063,51250,28375,26765,3041,27667,2246,54432,5287,"Washington County, New York(6,10)",88.7,71,"Washington County, New York",63.1,50,stable,62230,36,115,63.1,88.7
NY,"Wayne County, New York",11541,5486,6055,36117,50798,51394,26912,NA,58750,46083,40840,4148,42943,3420,83783,7568,"Wayne County, New York(6,10)",72.8,84,"Wayne County, New York",54.1,62,stable,91446,36,117,54.1,72.8
NY,"Westchester County, New York",90752,39737,51015,36119,83958,98072,52543,53778,119372,52738,407309,52745,455397,38864,862706,91609,"Westchester County, New York(6,10)",53.2,615,"Westchester County, New York",33.9,397,falling,976396,36,119,33.9,53.2
NY,"Wyoming County, New York",4425,2081,2344,36121,52564,52655,NA,80893,NA,60481,17208,1597,17779,1163,34987,2760,"Wyoming County, New York(6,10)",68.3,34,"Wyoming County, New York",53.2,26,stable,41013,36,121,53.2,68.3
NY,"Yates County, New York",3446,1583,1863,36123,49510,49971,45967,NA,NA,64000,9630,2453,10188,2558,19818,5011,"Yates County, New York(6,10)",73.2,25,"Yates County, New York",52.7,18,falling,25048,36,123,52.7,73.2
OH,"Adams County, Ohio",6832,2970,3862,39001,35560,36101,NA,15104,NA,14188,11652,2202,12190,1922,23842,4124,"Adams County, Ohio(6,10)",87.1,32,"Adams County, Ohio",74.5,27,stable,28024,39,1,74.5,87.1
OH,"Allen County, Ohio",17713,8327,9386,39003,44103,47434,22473,41458,79563,40595,44827,6106,47505,4170,92332,10276,"Allen County, Ohio(6,10)",70.4,90,"Allen County, Ohio",53.5,69,falling,104425,39,3,53.5,70.4
OH,"Ashland County, Ohio",7569,3496,4073,39005,48003,48293,NA,NA,NA,49722,22362,3470,23713,3127,46075,6597,"Ashland County, Ohio(6,10)",61.2,41,"Ashland County, Ohio",53.5,35,stable,53213,39,5,53.5,61.2
OH,"Ashtabula County, Ohio",19266,8329,10937,39007,40544,41424,25797,18155,77784,30833,41075,6662,43352,5542,84427,12204,"Ashtabula County, Ohio(6,10)",79.2,103,"Ashtabula County, Ohio",60,78,stable,98632,39,7,60,79.2
OH,"Athens County, Ohio",18263,9227,9036,39009,33872,34650,NA,NA,19583,NA,29257,2799,29877,2350,59134,5149,"Athens County, Ohio(6,10)",76.6,43,"Athens County, Ohio",63.1,34,stable,65886,39,9,63.1,76.6
OH,"Auglaize County, Ohio",4010,1627,2383,39011,54274,54571,NA,NA,NA,29879,21176,1386,21370,1430,42546,2816,"Auglaize County, Ohio(6,10)",68.1,40,"Auglaize County, Ohio",54.4,31,stable,45876,39,11,54.4,68.1
OH,"Belmont County, Ohio",9553,4021,5532,39013,43833,44091,39796,38333,NA,39087,28812,3352,30819,2786,59631,6138,"Belmont County, Ohio(6,10)",61.3,60,"Belmont County, Ohio",51,51,falling,69154,39,13,51,61.3
OH,"Brown County, Ohio",6442,2678,3764,39015,45568,45251,26615,NA,9323,59896,18406,3112,19983,2198,38389,5310,"Brown County, Ohio(6,10)",106.2,58,"Brown County, Ohio",75.1,41,stable,43839,39,15,75.1,106.2
OH,"Butler County, Ohio",50312,21472,28840,39017,57540,59769,39487,36496,74183,38868,163145,17748,173128,15304,336273,33052,"Butler County, Ohio(6,10)",75,285,"Butler County, Ohio",58.5,221,falling,376353,39,17,58.5,75
OH,"Carroll County, Ohio",4317,1997,2320,39019,47075,47532,NA,NA,NA,49205,12116,1990,12340,1632,24456,3622,"Carroll County, Ohio(6,10)",79.7,31,"Carroll County, Ohio",53.7,21,stable,27811,39,19,53.7,79.7
OH,"Champaign County, Ohio",4756,2217,2539,39021,50974,51301,35905,45875,NA,30333,17416,1966,18175,1353,35591,3319,"Champaign County, Ohio(6,10)",64,31,"Champaign County, Ohio",56.2,27,stable,38987,39,21,56.2,64
OH,"Clark County, Ohio",24419,10932,13487,39023,43625,45869,27147,31300,72000,31310,58470,6984,63812,5794,122282,12778,"Clark County, Ohio(6,10)",76.8,139,"Clark County, Ohio",60.7,112,falling,135959,39,23,60.7,76.8
OH,"Clermont County, Ohio",21127,9318,11809,39025,60805,61086,52860,59833,91012,51955,88894,9365,92534,8239,181428,17604,"Clermont County, Ohio(6,10)",85.3,181,"Clermont County, Ohio",61.3,127,falling,201973,39,25,61.3,85.3
OH,"Clinton County, Ohio",6425,3000,3425,39027,46787,47082,35714,NA,71316,NA,18135,2474,19000,1970,37135,4444,"Clinton County, Ohio(6,10)",86.6,42,"Clinton County, Ohio",68.2,33,stable,41917,39,27,68.2,86.6
OH,"Columbiana County, Ohio",15730,6792,8938,39029,44497,44474,24896,NA,71087,37917,44011,6434,46550,5526,90561,11960,"Columbiana County, Ohio(6,10)",68.6,101,"Columbiana County, Ohio",52.3,76,stable,104806,39,29,52.3,68.6
OH,"Coshocton County, Ohio",5835,2516,3319,39031,41701,41814,NA,NA,NA,75804,15556,2590,15536,2660,31092,5250,"Coshocton County, Ohio(6,10)",74,36,"Coshocton County, Ohio",64.6,31,stable,36569,39,31,64.6,74
OH,"Crawford County, Ohio",6888,2976,3912,39033,40795,40932,NA,NA,NA,37727,18546,2003,19625,2020,38171,4023,"Crawford County, Ohio(6,10)",66.6,41,"Crawford County, Ohio",54.4,33,stable,42306,39,33,54.4,66.6
OH,"Cuyahoga County, Ohio",231823,101682,130141,39035,44190,54296,26595,32750,64478,33026,526859,66437,601157,53215,1128016,119652,"Cuyahoga County, Ohio(6,10)",68.7,1108,"Cuyahoga County, Ohio",51.1,838,falling,1255921,39,35,51.1,68.7
OH,"Darke County, Ohio",6846,3045,3801,39037,44632,44957,NA,NA,NA,34301,22865,2645,24022,2213,46887,4858,"Darke County, Ohio(6,10)",65.9,46,"Darke County, Ohio",52.7,37,stable,52076,39,37,52.7,65.9
OH,"Defiance County, Ohio",5071,2187,2884,39039,50663,51628,31750,26771,NA,43846,16977,2192,17511,1679,34488,3871,"Defiance County, Ohio(6,10)",67.3,32,"Defiance County, Ohio",56.6,27,stable,38352,39,39,56.6,67.3
OH,"Delaware County, Ohio",8285,3705,4580,39041,91955,91973,67478,91313,120546,82313,86544,4668,89842,3441,176386,8109,"Delaware County, Ohio(6,10)",61,94,"Delaware County, Ohio",44.1,66,falling,193013,39,41,44.1,61
OH,"Erie County, Ohio",9333,4116,5217,39043,48011,50871,28489,NA,47841,43179,32644,4193,35368,3004,68012,7197,"Erie County, Ohio(6,10)",65,71,"Erie County, Ohio",54.4,59,falling,75550,39,43,54.4,65
OH,"Fairfield County, Ohio",15110,6752,8358,39045,60567,60323,67900,83784,71591,46855,66091,5886,69770,4743,135861,10629,"Fairfield County, Ohio(6,10)",73.6,117,"Fairfield County, Ohio",54.3,86,stable,151408,39,45,54.3,73.6
OH,"Fayette County, Ohio",5185,2461,2724,39047,40503,40701,37200,NA,82500,31813,12093,1818,12750,1609,24843,3427,"Fayette County, Ohio(6,10)",87.4,32,"Fayette County, Ohio",67.7,24,stable,28679,39,47,67.7,87.4
OH,"Franklin County, Ohio",208422,95908,112514,39049,52341,59586,32571,22340,68486,37220,511117,77423,557121,62162,1068238,139585,"Franklin County, Ohio(6,10)",70.3,736,"Franklin County, Ohio",53.5,553,falling,1251722,39,49,53.5,70.3
OH,"Fulton County, Ohio",4532,2197,2335,39051,55120,56044,NA,51667,61932,43864,19523,1367,20214,999,39737,2366,"Fulton County, Ohio(6,10)",48.4,25,"Fulton County, Ohio",45.3,24,stable,42537,39,51,45.3,48.4
OH,"Gallia County, Ohio",6214,2541,3673,39053,37319,37946,19375,39875,NA,NA,12476,2209,13705,1756,26181,3965,"Gallia County, Ohio(6,10)",88.7,35,"Gallia County, Ohio",67.2,26,stable,30142,39,53,67.2,88.7
OH,"Geauga County, Ohio",6969,3258,3711,39055,72430,72865,57235,NA,107895,52910,40116,5896,42688,4557,82804,10453,"Geauga County, Ohio(6,10)",51.4,63,"Geauga County, Ohio",35.2,43,falling,94102,39,55,35.2,51.4
OH,"Greene County, Ohio",21065,9574,11491,39057,60113,61720,37255,80357,66706,55721,71331,6600,77789,4516,149120,11116,"Greene County, Ohio(6,10)",60.9,113,"Greene County, Ohio",43.5,81,falling,164427,39,57,43.5,60.9
OH,"Guernsey County, Ohio",7784,3427,4357,39059,40930,41395,17222,NA,NA,29231,16774,2444,18074,1851,34848,4295,"Guernsey County, Ohio(6,10)",82.2,43,"Guernsey County, Ohio",70.6,37,stable,39258,39,59,70.6,82.2
OH,"Hamilton County, Ohio",143778,63809,79969,39061,49013,60687,25901,22138,63347,40458,339523,43509,380210,32950,719733,76459,"Hamilton County, Ohio(6,10)",75.1,673,"Hamilton County, Ohio",55.7,500,falling,807598,39,61,55.7,75.1
OH,"Hancock County, Ohio",10221,4369,5852,39063,50895,51183,NA,NA,59722,41724,33307,3300,35026,2975,68333,6275,"Hancock County, Ohio(6,10)",57.9,52,"Hancock County, Ohio",48.4,44,stable,75573,39,63,48.4,57.9
OH,"Hardin County, Ohio",5491,2667,2824,39065,42703,43034,NA,NA,60469,31757,13877,1873,13905,1877,27782,3750,"Hardin County, Ohio(6,10)",72.9,26,"Hardin County, Ohio",57.9,21,stable,31682,39,65,57.9,72.9
OH,"Harrison County, Ohio",2657,1186,1471,39067,43173,43177,32604,NA,NA,82344,6814,776,6933,858,13747,1634,"Harrison County, Ohio(6,10)",72.7,17,"Harrison County, Ohio",57.6,14,stable,15450,39,67,57.6,72.7
OH,"Henry County, Ohio",3144,1325,1819,39069,53835,54239,10972,NA,91250,37955,12487,1198,13137,831,25624,2029,"Henry County, Ohio(6,10)",55.3,20,"Henry County, Ohio",48.2,18,stable,27816,39,69,48.2,55.3
OH,"Highland County, Ohio",8604,3780,4824,39071,39858,40181,23098,NA,NA,NA,18337,2813,18763,2841,37100,5654,"Highland County, Ohio(6,10)",75.8,41,"Highland County, Ohio",66.7,36,stable,43026,39,71,66.7,75.8
OH,"Hocking County, Ohio",4894,2116,2778,39073,42170,42083,NA,NA,107667,NA,12117,1860,12703,1551,24820,3411,"Hocking County, Ohio(6,10)",75.9,28,"Hocking County, Ohio",66.3,25,stable,28491,39,73,66.3,75.9
OH,"Holmes County, Ohio",5398,2451,2947,39075,51996,52297,NA,NA,NA,34613,12699,8654,12058,9249,24757,17903,"Holmes County, Ohio(6,10)",40,16,"Holmes County, Ohio",26.3,11,stable,43909,39,75,26.3,40
OH,"Huron County, Ohio",7853,3501,4352,39077,48745,49245,26948,40625,NA,33578,25591,3298,27087,2445,52678,5743,"Huron County, Ohio(6,10)",78.2,54,"Huron County, Ohio",63.3,43,stable,58469,39,77,63.3,78.2
OH,"Jackson County, Ohio",7637,3320,4317,39079,39460,40088,NA,NA,NA,NA,13973,1942,14869,1741,28842,3683,"Jackson County, Ohio(6,10)",82.3,33,"Jackson County, Ohio",66.2,27,stable,32596,39,79,66.2,82.3
OH,"Jefferson County, Ohio",11533,4875,6658,39081,41942,42899,21607,NA,45469,NA,29123,3514,31757,2923,60880,6437,"Jefferson County, Ohio(6,10)",78.6,78,"Jefferson County, Ohio",58.7,59,falling,67347,39,81,58.7,78.6
OH,"Knox County, Ohio",8825,3995,4830,39083,48533,48635,NA,NA,52794,47534,25850,3783,27262,3531,53112,7314,"Knox County, Ohio(6,10)",69.8,51,"Knox County, Ohio",48,35,stable,61061,39,83,48,69.8
OH,"Lake County, Ohio",20063,8926,11137,39085,58029,59227,29156,NA,75775,48125,101515,9739,107925,8200,209440,17939,"Lake County, Ohio(6,10)",73,222,"Lake County, Ohio",55.4,169,falling,229245,39,85,55.4,73
OH,"Lawrence County, Ohio",11135,5080,6055,39087,42874,43448,25991,NA,21721,NA,26399,3593,28448,2803,54847,6396,"Lawrence County, Ohio(6,10)",83.4,66,"Lawrence County, Ohio",67.8,53,stable,61109,39,87,67.8,83.4
OH,"Licking County, Ohio",20926,9134,11792,39089,56549,56635,69714,40156,56600,57955,74195,7804,77981,7386,152176,15190,"Licking County, Ohio(6,10)",78.5,149,"Licking County, Ohio",60.1,113,falling,170570,39,89,60.1,78.5
OH,"Logan County, Ohio",6487,2767,3720,39091,49783,50065,45465,NA,61016,NA,19176,3129,20589,2276,39765,5405,"Logan County, Ohio(6,10)",70.7,40,"Logan County, Ohio",60,34,stable,45386,39,91,60,70.7
OH,"Lorain County, Ohio",42269,17426,24843,39093,52457,55261,28250,29167,74417,37303,130768,13366,141653,10783,272421,24149,"Lorain County, Ohio(6,10)",71,259,"Lorain County, Ohio",55.1,200,falling,305147,39,93,55.1,71
OH,"Lucas County, Ohio",90091,42034,48057,39095,41777,48823,21855,32794,51140,35328,183219,25409,203622,18716,386841,44125,"Lucas County, Ohio(6,10)",61.9,306,"Lucas County, Ohio",55.4,275,falling,433689,39,95,55.4,61.9
OH,"Madison County, Ohio",3580,1621,1959,39097,57406,57824,45250,31250,NA,41250,16709,2312,18209,1293,34918,3605,"Madison County, Ohio(6,10)",74.8,36,"Madison County, Ohio",52.8,25,stable,44094,39,97,52.8,74.8
OH,"Mahoning County, Ohio",40841,17922,22919,39099,41375,45612,21408,31019,58070,29869,98779,11550,109376,9338,208155,20888,"Mahoning County, Ohio(6,10)",69.4,232,"Mahoning County, Ohio",53.4,183,falling,231900,39,99,53.4,69.4
OH,"Marion County, Ohio",11127,4978,6149,39101,42966,43940,27000,65714,NA,34350,25849,3294,27630,3027,53479,6321,"Marion County, Ohio(6,10)",82.9,67,"Marion County, Ohio",62.2,51,stable,65355,39,101,62.2,82.9
OH,"Medina County, Ohio",12859,5798,7061,39103,66952,67277,31745,53375,86607,52922,79425,6220,82372,5707,161797,11927,"Medina County, Ohio(6,10)",62.1,123,"Medina County, Ohio",45.9,90,falling,176395,39,103,45.9,62.1
OH,"Meigs County, Ohio",5285,2498,2787,39105,37813,37829,NA,NA,NA,14028,9951,1527,10483,1304,20434,2831,"Meigs County, Ohio(6,10)",71.8,22,"Meigs County, Ohio",51.7,16,falling,23257,39,105,51.7,71.8
OH,"Mercer County, Ohio",3399,1428,1971,39107,53099,54059,NA,NA,NA,36364,18786,1591,18863,1252,37649,2843,"Mercer County, Ohio(6,10)",52.9,28,"Mercer County, Ohio",39.8,21,stable,40968,39,107,39.8,52.9
OH,"Miami County, Ohio",13076,5466,7610,39109,51569,51658,30361,120329,96830,39464,45696,4834,48031,4148,93727,8982,"Miami County, Ohio(6,10)",73.7,95,"Miami County, Ohio",54.9,72,stable,104224,39,109,54.9,73.7
OH,"Monroe County, Ohio",2782,1268,1514,39111,41528,41507,NA,NA,NA,NA,6389,842,6423,747,12812,1589,"Monroe County, Ohio(6,10)",60.3,13,"Monroe County, Ohio",54.6,12,stable,14409,39,111,54.6,60.3
OH,"Montgomery County, Ohio",96354,42909,53445,39113,43829,50144,27472,24545,63335,37217,221306,31005,249399,23700,470705,54705,"Montgomery County, Ohio(6,10)",76.4,507,"Montgomery County, Ohio",56.3,376,falling,532258,39,113,56.3,76.4
OH,"Morgan County, Ohio",3111,1481,1630,39115,37067,37258,39464,NA,54028,91563,6195,1159,6417,954,12612,2113,"Morgan County, Ohio(6,10)",80.5,18,"Morgan County, Ohio",64.8,14,stable,14777,39,115,64.8,80.5
OH,"Morrow County, Ohio",4063,2119,1944,39117,51993,52283,NA,NA,NA,88142,15638,1728,15715,1616,31353,3344,"Morrow County, Ohio(6,10)",80.1,34,"Morrow County, Ohio",54.2,22,stable,35074,39,117,54.2,80.1
OH,"Muskingum County, Ohio",15554,7155,8399,39119,41130,41844,29844,NA,21250,NA,36412,4893,39884,3967,76296,8860,"Muskingum County, Ohio(6,10)",80.6,87,"Muskingum County, Ohio",69.6,75,stable,86290,39,119,69.6,80.6
OH,"Noble County, Ohio",1521,670,851,39121,41708,41646,NA,NA,NA,NA,5243,646,5432,657,10675,1303,"Noble County, Ohio(6,10)",48.6,12,"Noble County, Ohio",37.5,9,stable,14326,39,121,37.5,48.6
OH,"Ottawa County, Ohio",4349,1803,2546,39123,53914,54373,37333,NA,41016,55587,18685,1501,19028,1519,37713,3020,"Ottawa County, Ohio(6,10)",66,43,"Ottawa County, Ohio",55.7,35,stable,40877,39,123,55.7,66
OH,"Paulding County, Ohio",2436,1188,1248,39125,45550,45581,NA,NA,NA,39911,8635,838,8773,817,17408,1655,"Paulding County, Ohio(6,10)",87.6,21,"Paulding County, Ohio",68.9,17,stable,18976,39,125,68.9,87.6
OH,"Perry County, Ohio",6876,2994,3882,39127,42017,42319,NA,NA,NA,NA,16107,1826,15993,1823,32100,3649,"Perry County, Ohio(6,10)",78.5,33,"Perry County, Ohio",63.3,26,stable,35985,39,127,63.3,78.5
OH,"Pickaway County, Ohio",6509,3040,3469,39129,57439,57523,NA,NA,250001,39000,23689,2254,24408,2016,48097,4270,"Pickaway County, Ohio(6,10)",77.5,49,"Pickaway County, Ohio",64.6,41,stable,56998,39,129,64.6,77.5
OH,"Pike County, Ohio",6436,3038,3398,39131,40283,40136,85338,NA,NA,NA,11707,2310,12640,1357,24347,3667,"Pike County, Ohio(6,10)",91.3,33,"Pike County, Ohio",67.8,24,stable,28217,39,131,67.8,91.3
OH,"Portage County, Ohio",24219,10238,13981,39133,52552,53792,35222,57935,39702,45682,71543,7060,75801,6452,147344,13512,"Portage County, Ohio(6,10)",72.1,128,"Portage County, Ohio",56.7,100,stable,162275,39,133,56.7,72.1
OH,"Preble County, Ohio",5477,2504,2973,39135,47818,47929,34722,NA,NA,NA,18511,2018,18795,2029,37306,4047,"Preble County, Ohio(6,10)",72.2,39,"Preble County, Ohio",57.7,31,stable,41329,39,135,57.7,72.2
OH,"Putnam County, Ohio",1966,831,1135,39137,60524,61208,148281,NA,NA,42349,16179,831,16121,790,32300,1621,"Putnam County, Ohio(6,10)",45.5,19,"Putnam County, Ohio",36.7,15,stable,34042,39,137,36.7,45.5
OH,"Richland County, Ohio",19504,8622,10882,39139,41877,43464,25978,11842,90650,36172,49703,6482,53371,6270,103074,12752,"Richland County, Ohio(6,10)",71.5,118,"Richland County, Ohio",56.2,93,stable,121707,39,139,56.2,71.5
OH,"Ross County, Ohio",13746,6062,7684,39141,43345,43924,37450,NA,NA,NA,31008,4216,33149,3191,64157,7407,"Ross County, Ohio(6,10)",85.2,79,"Ross County, Ohio",63.9,58,falling,77170,39,141,63.9,85.2
OH,"Sandusky County, Ohio",8458,3644,4814,39143,47209,48595,19911,NA,28036,38750,26820,2648,27470,2397,54290,5045,"Sandusky County, Ohio(6,10)",69.2,53,"Sandusky County, Ohio",56.2,43,stable,59679,39,143,56.2,69.2
OH,"Scioto County, Ohio",18740,8702,10038,39145,35903,36247,24967,19524,75104,NA,31964,4628,34529,4037,66493,8665,"Scioto County, Ohio(6,10)",97.8,96,"Scioto County, Ohio",73.2,71,stable,76825,39,145,73.2,97.8
OH,"Seneca County, Ohio",8923,4164,4759,39147,45444,46817,16411,NA,14020,33892,25100,2377,25497,1961,50597,4338,"Seneca County, Ohio(6,10)",72.1,49,"Seneca County, Ohio",54,38,stable,55610,39,147,54,72.1
OH,"Shelby County, Ohio",4970,2048,2922,39149,54550,55131,25057,46163,49924,29955,22360,2057,22913,1377,45273,3434,"Shelby County, Ohio(6,10)",55.7,32,"Shelby County, Ohio",44.2,24,stable,48901,39,149,44.2,55.7
OH,"Stark County, Ohio",53715,23898,29817,39151,47137,49412,26899,40192,85469,42409,161717,18295,175145,15018,336862,33313,"Stark County, Ohio(6,10)",68.1,338,"Stark County, Ohio",51.9,258,falling,375165,39,151,51.9,68.1
OH,"Summit County, Ohio",78658,35036,43622,39153,50765,55527,27300,34167,61991,43944,232858,27322,255090,21505,487948,48827,"Summit County, Ohio(6,10)",67.2,449,"Summit County, Ohio",52.3,352,stable,541968,39,153,52.3,67.2
OH,"Trumbull County, Ohio",34912,15220,19692,39155,43073,44862,24860,NA,49289,30066,85163,12942,94128,10463,179291,23405,"Trumbull County, Ohio(6,10)",80.8,237,"Trumbull County, Ohio",56.5,168,stable,203751,39,155,56.5,80.8
OH,"Tuscarawas County, Ohio",12763,5748,7015,39157,45310,45333,25969,35486,85606,46212,39847,5517,41619,4711,81466,10228,"Tuscarawas County, Ohio(6,10)",61,76,"Tuscarawas County, Ohio",45.3,56,stable,92916,39,157,45.3,61
OH,"Union County, Ohio",4344,1959,2385,39159,67382,66556,NA,60395,114844,51571,23304,1945,23504,1475,46808,3420,"Union County, Ohio(6,10)",68.9,33,"Union County, Ohio",54.5,26,stable,54277,39,159,54.5,68.9
OH,"Van Wert County, Ohio",3600,1623,1977,39161,48060,48502,43370,NA,NA,44167,12572,1307,13315,1101,25887,2408,"Van Wert County, Ohio(6,10)",56.2,21,"Van Wert County, Ohio",47.1,18,stable,28562,39,161,47.1,56.2
OH,"Vinton County, Ohio",2713,1100,1613,39163,40680,40896,NA,NA,NA,NA,5730,896,5921,614,11651,1510,"Vinton County, Ohio(6,10)",114.2,19,"Vinton County, Ohio",64.5,11,stable,13048,39,163,64.5,114.2
OH,"Warren County, Ohio",11885,4930,6955,39165,74379,73836,66111,NA,111173,69141,98462,6599,103216,5654,201678,12253,"Warren County, Ohio(6,10)",65.8,139,"Warren County, Ohio",49.4,102,falling,224469,39,165,49.4,65.8
OH,"Washington County, Ohio",9777,4438,5339,39167,43509,44345,37935,NA,86000,NA,26597,3277,28123,2685,54720,5962,"Washington County, Ohio(6,10)",75.8,67,"Washington County, Ohio",55.5,49,stable,61112,39,167,55.5,75.8
OH,"Wayne County, Ohio",14758,6498,8260,39169,50383,50526,30272,43000,52500,53304,48314,8351,49904,7723,98218,16074,"Wayne County, Ohio(6,10)",57,79,"Wayne County, Ohio",44.3,62,falling,116063,39,169,44.3,57
OH,"Williams County, Ohio",5386,2265,3121,39171,42492,42492,NA,57031,NA,49545,16155,1681,17156,1254,33311,2935,"Williams County, Ohio(6,10)",66,32,"Williams County, Ohio",48.2,23,falling,37120,39,171,48.2,66
OH,"Wood County, Ohio",17461,8079,9382,39173,53577,53636,47602,NA,85946,51563,58179,4587,61220,3660,119399,8247,"Wood County, Ohio(6,10)",53.3,73,"Wood County, Ohio",45,61,falling,129730,39,173,45,53.3
OH,"Wyandot County, Ohio",2601,1060,1541,39175,47555,47278,NA,NA,NA,44886,9865,1105,10393,840,20258,1945,"Wyandot County, Ohio(6,10)",74.4,22,"Wyandot County, Ohio",56.3,17,stable,22243,39,175,56.3,74.4
OK,"Adair County, Oklahoma",5897,2813,3084,40001,33404,32542,NA,35000,NA,24813,7818,3227,8131,2961,15949,6188,"Adair County, Oklahoma(6,10)",71.5,18,"Adair County, Oklahoma",52.7,13,falling,22004,40,1,52.7,71.5
OK,"Alfalfa County, Oklahoma",606,319,287,40003,50156,49976,NA,69375,NA,46094,2091,355,1982,294,4073,649,"Alfalfa County, Oklahoma(6,10)",61.2,5,"Alfalfa County, Oklahoma",53,5,stable,5868,40,3,53,61.2
OK,"Atoka County, Oklahoma",2794,1204,1590,40005,36661,37882,28347,37150,36250,24615,4620,1271,5148,1433,9768,2704,"Atoka County, Oklahoma(6,10)",80.2,14,"Atoka County, Oklahoma",49.9,9,stable,13793,40,5,49.9,80.2
OK,"Beaver County, Oklahoma",492,182,310,40007,52090,52917,NA,NA,NA,44740,2319,347,2318,467,4637,814,"Beaver County, Oklahoma(6,10)",*,3 or fewer,"Beaver County, Oklahoma",*,*,**,5427,40,7,NA,NA
OK,"Beckham County, Oklahoma",2777,1101,1676,40009,48601,48711,31108,NA,NA,74067,9006,1957,8870,1800,17876,3757,"Beckham County, Oklahoma(6,10)",53.8,13,"Beckham County, Oklahoma",44.7,10,stable,23768,40,9,44.7,53.8
OK,"Blaine County, Oklahoma",1293,524,769,40011,41972,42679,30893,NA,NA,17480,3144,469,3941,527,7085,996,"Blaine County, Oklahoma(6,10)",66.4,9,"Blaine County, Oklahoma",48.6,7,stable,9833,40,11,48.6,66.4
OK,"Bryan County, Oklahoma",7816,3424,4392,40013,38847,39412,30167,32955,44018,30169,16794,4402,18231,4136,35025,8538,"Bryan County, Oklahoma(6,10)",87.9,48,"Bryan County, Oklahoma",74,41,stable,44884,40,13,74,87.9
OK,"Caddo County, Oklahoma",5976,2901,3075,40015,40674,42953,30806,31625,NA,36111,10739,3495,10819,3197,21558,6692,"Caddo County, Oklahoma(6,10)",85.3,30,"Caddo County, Oklahoma",65.4,23,stable,29343,40,15,65.4,85.3
OK,"Canadian County, Oklahoma",8995,3890,5105,40017,64505,65112,49238,61409,71250,51835,54096,6921,57233,6067,111329,12988,"Canadian County, Oklahoma(6,10)",70.2,80,"Canadian County, Oklahoma",49.7,56,falling,133378,40,17,49.7,70.2
OK,"Carter County, Oklahoma",7262,3135,4127,40019,44531,46229,28368,35588,62614,38393,18995,4017,20961,3842,39956,7859,"Carter County, Oklahoma(6,10)",77.6,45,"Carter County, Oklahoma",64,38,stable,48689,40,19,64,77.6
OK,"Cherokee County, Oklahoma",10426,5020,5406,40021,38694,40489,21065,35514,73250,21039,18034,5459,18325,5702,36359,11161,"Cherokee County, Oklahoma(6,10)",79.3,41,"Cherokee County, Oklahoma",66.4,34,stable,48447,40,21,66.4,79.3
OK,"Choctaw County, Oklahoma",4297,1952,2345,40023,30617,30794,16875,37098,NA,40694,5331,1895,5919,1797,11250,3692,"Choctaw County, Oklahoma(6,10)",80.4,17,"Choctaw County, Oklahoma",70.6,15,stable,14997,40,23,70.6,80.4
OK,"Cimarron County, Oklahoma",414,174,240,40025,46680,48889,NA,71250,NA,32031,950,204,996,168,1946,372,"Cimarron County, Oklahoma(6,10)",*,3 or fewer,"Cimarron County, Oklahoma",*,*,**,2216,40,25,NA,NA
OK,"Cleveland County, Oklahoma",32758,15142,17616,40027,56452,57687,41039,51023,57823,46909,113205,16326,119149,14496,232354,30822,"Cleveland County, Oklahoma(6,10)",66.3,156,"Cleveland County, Oklahoma",49.7,116,falling,274458,40,27,49.7,66.3
OK,"Coal County, Oklahoma",1186,515,671,40029,38243,38676,NA,34375,NA,38000,2095,743,2242,666,4337,1409,"Coal County, Oklahoma(6,10)",85.8,7,"Coal County, Oklahoma",81.1,7,stable,5651,40,29,81.1,85.8
OK,"Comanche County, Oklahoma",20444,8810,11634,40031,46241,49778,36806,35368,41372,46106,44938,8863,50108,8306,95046,17169,"Comanche County, Oklahoma(6,10)",72.8,80,"Comanche County, Oklahoma",58.2,63,stable,124648,40,31,58.2,72.8
OK,"Cotton County, Oklahoma",1030,467,563,40033,46361,51097,32125,21893,NA,52188,2377,585,2497,531,4874,1116,"Cotton County, Oklahoma(6,10)",59.8,5,"Cotton County, Oklahoma",63.5,5,stable,5996,40,33,63.5,59.8
OK,"Craig County, Oklahoma",2659,1162,1497,40035,38876,40364,25577,34875,55417,38203,5675,1233,5666,1430,11341,2663,"Craig County, Oklahoma(6,10)",85.9,18,"Craig County, Oklahoma",76.6,16,stable,14818,40,35,76.6,85.9
OK,"Creek County, Oklahoma",10813,4877,5936,40037,45016,47196,22500,39970,NA,36691,28847,5822,29842,5449,58689,11271,"Creek County, Oklahoma(6,10)",87.7,78,"Creek County, Oklahoma",67.1,60,stable,70892,40,37,67.1,87.7
OK,"Custer County, Oklahoma",4595,2089,2506,40039,46125,47572,29034,45250,36339,35676,11710,2539,11990,2291,23700,4830,"Custer County, Oklahoma(6,10)",71.5,21,"Custer County, Oklahoma",60.2,18,stable,29744,40,39,60.2,71.5
OK,"Delaware County, Oklahoma",8311,3830,4481,40041,37942,40000,23875,30428,52740,32583,16145,4162,16743,3980,32888,8142,"Delaware County, Oklahoma(6,10)",71.3,46,"Delaware County, Oklahoma",57.8,37,falling,41459,40,41,57.8,71.3
OK,"Dewey County, Oklahoma",788,367,421,40043,50904,51865,NA,NA,NA,47000,2008,415,2034,302,4042,717,"Dewey County, Oklahoma(6,10)",48.3,4,"Dewey County, Oklahoma",56.5,4,stable,4995,40,43,56.5,48.3
OK,"Ellis County, Oklahoma",595,291,304,40045,50855,50987,NA,41250,NA,37188,1793,244,1874,184,3667,428,"Ellis County, Oklahoma(6,10)",65.8,4,"Ellis County, Oklahoma",50,3,**,4231,40,45,50,65.8
OK,"Garfield County, Oklahoma",7852,3563,4289,40047,48238,49506,37755,50036,46685,40806,24926,4571,26885,3714,51811,8285,"Garfield County, Oklahoma(6,10)",62.4,46,"Garfield County, Oklahoma",51.8,39,stable,63569,40,47,51.8,62.4
OK,"Garvin County, Oklahoma",5038,2280,2758,40049,40524,40610,35046,42212,56912,38750,11088,2352,11481,2294,22569,4646,"Garvin County, Oklahoma(6,10)",87.9,32,"Garvin County, Oklahoma",72.2,26,stable,27755,40,49,72.2,87.9
OK,"Grady County, Oklahoma",6690,2780,3910,40051,52279,53478,30469,52794,NA,40000,22055,4218,22808,3956,44863,8174,"Grady County, Oklahoma(6,10)",67.6,41,"Grady County, Oklahoma",56.7,35,falling,54648,40,51,56.7,67.6
OK,"Grant County, Oklahoma",430,156,274,40053,50250,50448,NA,24167,NA,60263,2010,177,1982,270,3992,447,"Grant County, Oklahoma(6,10)",60.2,4,"Grant County, Oklahoma",64,5,**,4523,40,53,64,60.2
OK,"Greer County, Oklahoma",735,346,389,40055,40125,41349,NA,NA,NA,NA,2078,458,2015,490,4093,948,"Greer County, Oklahoma(6,10)",89.8,7,"Greer County, Oklahoma",65,5,stable,6070,40,55,65,89.8
OK,"Harmon County, Oklahoma",481,172,309,40057,31250,38083,21964,81250,NA,18015,1104,235,1257,164,2361,399,"Harmon County, Oklahoma(6,10)",*,3 or fewer,"Harmon County, Oklahoma",*,*,**,2788,40,57,NA,NA
OK,"Harper County, Oklahoma",520,272,248,40059,48359,48691,NA,NA,NA,47750,1568,307,1643,232,3211,539,"Harper County, Oklahoma(6,10)",76.8,4,"Harper County, Oklahoma",*,*,**,3754,40,59,NA,76.8
OK,"Haskell County, Oklahoma",2524,1126,1398,40061,35252,35290,NA,36797,51000,27614,4857,1485,4929,1510,9786,2995,"Haskell County, Oklahoma(6,10)",75.8,13,"Haskell County, Oklahoma",69.9,12,stable,12845,40,61,69.9,75.8
OK,"Hughes County, Oklahoma",2244,1025,1219,40063,35563,36758,32500,27614,NA,28393,4591,1275,4939,1300,9530,2575,"Hughes County, Oklahoma(6,10)",88.5,17,"Hughes County, Oklahoma",77.6,15,stable,13735,40,63,77.6,88.5
OK,"Jackson County, Oklahoma",4276,1665,2611,40065,41560,44890,30684,36702,62066,33347,9811,1887,10682,2080,20493,3967,"Jackson County, Oklahoma(6,10)",58.6,17,"Jackson County, Oklahoma",58.6,17,stable,25574,40,65,58.6,58.6
OK,"Jefferson County, Oklahoma",1313,607,706,40067,33449,33715,NA,35313,NA,19010,2425,695,2433,636,4858,1331,"Jefferson County, Oklahoma(6,10)",79,7,"Jefferson County, Oklahoma",64.3,6,stable,6276,40,67,64.3,79
OK,"Johnston County, Oklahoma",2070,777,1293,40069,38776,40136,9034,41818,NA,39583,4257,1055,4298,1292,8555,2347,"Johnston County, Oklahoma(6,10)",54.9,8,"Johnston County, Oklahoma",60,9,falling,10980,40,69,60,54.9
OK,"Kay County, Oklahoma",8137,3467,4670,40071,42134,43037,18185,35000,55268,32227,18064,4099,19228,3530,37292,7629,"Kay County, Oklahoma(6,10)",72.9,45,"Kay County, Oklahoma",64.7,40,stable,45366,40,71,64.7,72.9
OK,"Kingfisher County, Oklahoma",1093,481,612,40073,60034,60831,NA,73542,NA,52389,6676,903,6395,1169,13071,2072,"Kingfisher County, Oklahoma(6,10)",70.4,13,"Kingfisher County, Oklahoma",54.5,10,stable,15584,40,73,54.5,70.4
OK,"Kiowa County, Oklahoma",1883,806,1077,40075,39909,41470,29583,24063,NA,36250,3787,676,3804,836,7591,1512,"Kiowa County, Oklahoma(6,10)",75.1,10,"Kiowa County, Oklahoma",66.1,9,stable,9144,40,75,66.1,75.1
OK,"Latimer County, Oklahoma",1833,776,1057,40077,39205,41102,NA,30357,NA,31625,4119,1194,4221,1032,8340,2226,"Latimer County, Oklahoma(6,10)",59.9,9,"Latimer County, Oklahoma",56.4,9,falling,10483,40,77,56.4,59.9
OK,"Le Flore County, Oklahoma",11035,4903,6132,40079,36490,37389,18421,33438,31520,33500,18447,5735,19478,5085,37925,10820,"Le Flore County, Oklahoma(6,10)",62.2,38,"Le Flore County, Oklahoma",75.4,47,stable,49605,40,79,75.4,62.2
OK,"Lincoln County, Oklahoma",5335,2418,2917,40081,45149,46002,24375,37625,NA,37639,14153,2800,14337,2813,28490,5613,"Lincoln County, Oklahoma(6,10)",66.3,30,"Lincoln County, Oklahoma",66.4,29,stable,35042,40,81,66.4,66.3
OK,"Logan County, Oklahoma",4943,2388,2555,40083,55299,60028,27348,40081,250001,52448,18313,3563,19275,2987,37588,6550,"Logan County, Oklahoma(6,10)",67.4,32,"Logan County, Oklahoma",50.3,24,falling,45996,40,83,50.3,67.4
OK,"Love County, Oklahoma",1292,604,688,40085,44549,44626,40278,44688,NA,40250,3860,847,4177,694,8037,1541,"Love County, Oklahoma(6,10)",57.5,7,"Love County, Oklahoma",48.4,6,stable,9870,40,85,48.4,57.5
OK,"McClain County, Oklahoma",3944,1922,2022,40087,56088,55531,NA,63456,NA,56563,15556,2496,15845,2338,31401,4834,"McClain County, Oklahoma(6,10)",83,32,"McClain County, Oklahoma",60.1,23,stable,38066,40,87,60.1,83
OK,"McCurtain County, Oklahoma",8256,3703,4553,40089,32324,34778,19265,31446,NA,24471,12335,3672,12912,3806,25247,7478,"McCurtain County, Oklahoma(6,10)",94.2,39,"McCurtain County, Oklahoma",65.6,27,stable,33048,40,89,65.6,94.2
OK,"McIntosh County, Oklahoma",4209,1975,2234,40091,36011,38664,25655,30156,NA,39153,7958,1904,8188,1922,16146,3826,"McIntosh County, Oklahoma(6,10)",76.9,26,"McIntosh County, Oklahoma",70.1,24,stable,19990,40,91,70.1,76.9
OK,"Major County, Oklahoma",1073,456,617,40093,51571,53105,NA,32353,NA,30938,3355,473,3344,464,6699,937,"Major County, Oklahoma(6,10)",59.3,6,"Major County, Oklahoma",42.7,5,stable,7771,40,93,42.7,59.3
OK,"Marshall County, Oklahoma",2645,1134,1511,40095,40475,41250,12750,32308,NA,44375,6309,1554,6322,1597,12631,3151,"Marshall County, Oklahoma(6,10)",71.7,18,"Marshall County, Oklahoma",61.9,15,stable,16232,40,95,61.9,71.7
OK,"Mayes County, Oklahoma",8585,3814,4771,40097,42071,42318,NA,40219,48194,38750,15800,4325,16888,3557,32688,7882,"Mayes County, Oklahoma(6,10)",84.2,44,"Mayes County, Oklahoma",63.9,33,stable,40887,40,97,63.9,84.2
OK,"Murray County, Oklahoma",2012,764,1248,40099,47077,46940,NA,37625,NA,53164,5264,1276,5525,1259,10789,2535,"Murray County, Oklahoma(6,10)",97.5,18,"Murray County, Oklahoma",66.9,13,falling,13936,40,99,66.9,97.5
OK,"Muskogee County, Oklahoma",14670,6326,8344,40101,39984,41909,27149,38400,70850,28882,25770,6904,27841,6878,53611,13782,"Muskogee County, Oklahoma(6,10)",97.9,84,"Muskogee County, Oklahoma",74,63,stable,69699,40,101,74,97.9
OK,"Noble County, Oklahoma",1515,695,820,40103,48285,50219,NA,52031,NA,NA,4961,617,5314,514,10275,1131,"Noble County, Oklahoma(6,10)",59.7,9,"Noble County, Oklahoma",48.7,8,stable,11554,40,103,48.7,59.7
OK,"Nowata County, Oklahoma",1928,881,1047,40105,39875,41162,23958,35741,NA,40385,4128,968,4379,876,8507,1844,"Nowata County, Oklahoma(6,10)",59.7,9,"Nowata County, Oklahoma",54.9,8,stable,10539,40,105,54.9,59.7
OK,"Okfuskee County, Oklahoma",2797,1344,1453,40107,36216,41474,24545,24959,NA,42955,4562,1234,4333,1219,8895,2453,"Okfuskee County, Oklahoma(6,10)",65.3,11,"Okfuskee County, Oklahoma",64.6,10,stable,12181,40,107,64.6,65.3
OK,"Oklahoma County, Oklahoma",134377,59501,74876,40109,47437,52362,31816,43039,54457,35187,290614,69706,319677,62086,610291,131792,"Oklahoma County, Oklahoma(6,10)",69.5,513,"Oklahoma County, Oklahoma",55.9,409,falling,776864,40,109,55.9,69.5
OK,"Okmulgee County, Oklahoma",7880,3555,4325,40111,38843,42123,24688,33393,NA,36548,15883,3339,16422,3157,32305,6496,"Okmulgee County, Oklahoma(6,10)",95.2,48,"Okmulgee County, Oklahoma",71.9,36,stable,39187,40,111,71.9,95.2
OK,"Osage County, Oklahoma",7365,3002,4363,40113,45443,47252,36786,41126,NA,33897,19240,3500,20344,3542,39584,7042,"Osage County, Oklahoma(6,10)",55.9,36,"Osage County, Oklahoma",56,36,falling,47887,40,113,56,55.9
OK,"Ottawa County, Oklahoma",7112,3361,3751,40115,36347,37140,25000,35521,48125,28500,12486,3031,13216,2909,25702,5940,"Ottawa County, Oklahoma(6,10)",80.2,34,"Ottawa County, Oklahoma",74,32,falling,31981,40,115,74,80.2
OK,"Pawnee County, Oklahoma",2249,980,1269,40117,45765,46325,23500,41012,NA,61339,6814,1378,6761,1390,13575,2768,"Pawnee County, Oklahoma(6,10)",77.7,18,"Pawnee County, Oklahoma",58.3,13,stable,16436,40,117,58.3,77.7
OK,"Payne County, Oklahoma",18483,9075,9408,40119,37667,39904,27481,25707,17557,29145,33802,5931,33833,4760,67635,10691,"Payne County, Oklahoma(6,10)",62,42,"Payne County, Oklahoma",51.8,35,stable,80850,40,119,51.8,62
OK,"Pittsburg County, Oklahoma",7994,3657,4337,40121,42576,43464,55893,38214,49167,40909,17011,4194,17701,4141,34712,8335,"Pittsburg County, Oklahoma(6,10)",76.3,47,"Pittsburg County, Oklahoma",65.9,41,stable,44610,40,121,65.9,76.3
OK,"Pontotoc County, Oklahoma",6769,3222,3547,40123,43261,45748,31639,36151,NA,29279,14501,3790,15928,3381,30429,7171,"Pontotoc County, Oklahoma(6,10)",73.3,33,"Pontotoc County, Oklahoma",60.1,27,stable,38194,40,123,60.1,73.3
OK,"Pottawatomie County, Oklahoma",12288,5580,6708,40125,44688,46860,25403,37856,72981,34337,27591,5917,29672,5679,57263,11596,"Pottawatomie County, Oklahoma(6,10)",85.4,70,"Pottawatomie County, Oklahoma",60.9,49,stable,71875,40,125,60.9,85.4
OK,"Pushmataha County, Oklahoma",2716,1195,1521,40127,32445,32382,33750,29375,2499,45156,4053,1387,4462,1195,8515,2582,"Pushmataha County, Oklahoma(6,10)",65.2,11,"Pushmataha County, Oklahoma",81.6,14,stable,11183,40,127,81.6,65.2
OK,"Roger Mills County, Oklahoma",544,246,298,40129,50739,50823,NA,NA,NA,17500,1630,235,1652,240,3282,475,"Roger Mills County, Oklahoma(6,10)",*,3 or fewer,"Roger Mills County, Oklahoma",*,*,**,3788,40,129,NA,NA
OK,"Rogers County, Oklahoma",8271,3365,4906,40131,58139,59876,55625,49853,53819,67961,38004,5648,39145,5424,77149,11072,"Rogers County, Oklahoma(6,10)",62.8,64,"Rogers County, Oklahoma",49.2,49,falling,90802,40,131,49.2,62.8
OK,"Seminole County, Oklahoma",5371,2334,3037,40133,36068,37475,20208,35587,22500,37500,9442,2759,10115,2725,19557,5484,"Seminole County, Oklahoma(6,10)",85.9,29,"Seminole County, Oklahoma",72.4,24,stable,25548,40,133,72.4,85.9
OK,"Sequoyah County, Oklahoma",10261,5048,5213,40135,35736,35609,19594,36031,28750,22958,15333,4912,16477,4370,31810,9282,"Sequoyah County, Oklahoma(6,10)",71.1,38,"Sequoyah County, Oklahoma",70.4,37,stable,41153,40,135,70.4,71.1
OK,"Stephens County, Oklahoma",6740,2876,3864,40137,43781,44048,21776,42379,47159,36696,18163,3303,19398,3340,37561,6643,"Stephens County, Oklahoma(6,10)",69.2,42,"Stephens County, Oklahoma",54.4,33,falling,44581,40,137,54.4,69.2
OK,"Texas County, Oklahoma",2733,1158,1575,40139,50242,51486,NA,68864,96406,43152,8757,2504,8372,1825,17129,4329,"Texas County, Oklahoma(6,10)",51.3,9,"Texas County, Oklahoma",39.9,7,stable,21489,40,139,39.9,51.3
OK,"Tillman County, Oklahoma",1750,848,902,40141,37759,40458,29625,42625,49250,27375,2957,668,3127,598,6084,1266,"Tillman County, Oklahoma(6,10)",59.7,6,"Tillman County, Oklahoma",35.7,4,stable,7515,40,141,35.7,59.7
OK,"Tulsa County, Oklahoma",96498,42178,54320,40143,49759,54305,27294,45838,52177,39517,247089,54017,268472,48606,515561,102623,"Tulsa County, Oklahoma(6,10)",67.1,421,"Tulsa County, Oklahoma",52.6,328,falling,639242,40,143,52.6,67.1
OK,"Wagoner County, Oklahoma",8150,3605,4545,40145,55715,56989,41157,51250,68281,58438,31523,5502,33066,4991,64589,10493,"Wagoner County, Oklahoma(6,10)",68.8,56,"Wagoner County, Oklahoma",55.3,43,falling,76559,40,145,55.3,68.8
OK,"Washington County, Oklahoma",7307,3205,4102,40147,50023,51193,26719,36042,81951,40602,20860,3976,22595,3927,43455,7903,"Washington County, Oklahoma(6,10)",78.6,56,"Washington County, Oklahoma",58.7,42,stable,52021,40,147,58.7,78.6
OK,"Washita County, Oklahoma",1725,666,1059,40149,49632,50265,NA,37321,NA,30707,5025,707,5024,670,10049,1377,"Washita County, Oklahoma(6,10)",52.9,8,"Washita County, Oklahoma",51.3,8,stable,11661,40,149,51.3,52.9
OK,"Woods County, Oklahoma",1283,662,621,40151,55315,55833,23060,60278,NA,60000,3677,585,3657,402,7334,987,"Woods County, Oklahoma(6,10)",55.5,6,"Woods County, Oklahoma",45.1,5,**,9304,40,151,45.1,55.5
OK,"Woodward County, Oklahoma",2595,1056,1539,40153,55300,55599,NA,53295,NA,45139,9307,902,8779,978,18086,1880,"Woodward County, Oklahoma(6,10)",41,10,"Woodward County, Oklahoma",37.1,9,stable,21559,40,153,37.1,41
OR,"Baker County, Oregon",2353,1144,1209,41001,41098,41516,NA,NA,35893,29750,6847,845,6962,883,13809,1728,"Baker County, Oregon(6,10)",65,18,"Baker County, Oregon",50.4,14,stable,16005,41,1,50.4,65
OR,"Benton County, Oregon",18139,9502,8637,41003,49802,52242,NA,58594,27778,36213,39465,3980,39520,3280,78985,7260,"Benton County, Oregon(6,10)",48.9,43,"Benton County, Oregon",39.2,35,falling,87572,41,3,39.2,48.9
OR,"Clackamas County, Oregon",36894,16509,20385,41005,65965,66332,51855,35240,76919,48272,171023,19794,179518,17540,350541,37334,"Clackamas County, Oregon(6,10)",55.2,245,"Clackamas County, Oregon",43.2,189,falling,401515,41,5,43.2,55.2
OR,"Clatsop County, Oregon",5791,2590,3201,41007,46408,47513,NA,36375,66094,36473,15177,2761,16376,2292,31553,5053,"Clatsop County, Oregon(6,10)",72.4,37,"Clatsop County, Oregon",52.2,27,stable,37831,41,7,52.2,72.4
OR,"Columbia County, Oregon",6638,3004,3634,41009,53179,53387,50583,43304,67128,27097,21777,2706,22015,2569,43792,5275,"Columbia County, Oregon(6,10)",63.2,38,"Columbia County, Oregon",54.4,32,falling,49600,41,9,54.4,63.2
OR,"Coos County, Oregon",11310,5154,6156,41011,38605,39176,9214,27623,61513,35583,25506,4579,27783,3960,53289,8539,"Coos County, Oregon(6,10)",73.5,78,"Coos County, Oregon",64.2,69,falling,63121,41,11,64.2,73.5
OR,"Crook County, Oregon",4048,1787,2261,41013,37106,37435,NA,51016,NA,54474,9015,1309,9178,1372,18193,2681,"Crook County, Oregon(6,10)",54,19,"Crook County, Oregon",41.6,14,falling,21630,41,13,41.6,54
OR,"Curry County, Oregon",3682,1519,2163,41015,40884,41211,NA,NA,50132,56150,9356,1432,10131,1275,19487,2707,"Curry County, Oregon(6,10)",61.9,29,"Curry County, Oregon",50.8,24,falling,22483,41,15,50.8,61.9
OR,"Deschutes County, Oregon",24220,11509,12711,41017,51223,51897,19416,32684,43006,37656,69387,12338,72618,11600,142005,23938,"Deschutes County, Oregon(6,10)",53.1,105,"Deschutes County, Oregon",37.7,74,falling,175268,41,17,37.7,53.1
OR,"Douglas County, Oregon",20377,8874,11503,41019,41312,41529,NA,23500,103229,30586,45725,6764,48143,5915,93868,12679,"Douglas County, Oregon(6,10)",67,118,"Douglas County, Oregon",59.7,107,falling,107685,41,19,59.7,67
OR,"Gilliam County, Oregon",186,81,105,41021,44293,45404,NA,NA,NA,38571,754,177,787,152,1541,329,"Gilliam County, Oregon(6,10)",*,3 or fewer,"Gilliam County, Oregon",*,*,**,1859,41,21,NA,NA
OR,"Grant County, Oregon",1138,508,630,41023,38046,38680,NA,17063,NA,NA,3005,487,3207,443,6212,930,"Grant County, Oregon(6,10)",41.9,6,"Grant County, Oregon",29.8,4,falling,7185,41,23,29.8,41.9
OR,"Harney County, Oregon",1268,573,695,41025,37580,37775,46875,31607,NA,NA,3115,433,3168,407,6283,840,"Harney County, Oregon(6,10)",43.9,5,"Harney County, Oregon",43.3,5,falling,7200,41,25,43.3,43.9
OR,"Hood River County, Oregon",3223,1435,1788,41027,55827,57009,NA,NA,NA,53247,9311,1994,9671,1692,18982,3686,"Hood River County, Oregon(6,10)",45.6,11,"Hood River County, Oregon",40.9,10,stable,23137,41,27,40.9,45.6
OR,"Jackson County, Oregon",39122,18447,20675,41029,44028,44599,33798,22617,51042,35653,84534,16280,92282,14188,176816,30468,"Jackson County, Oregon(6,10)",62.6,184,"Jackson County, Oregon",45.6,134,falling,212567,41,29,45.6,62.6
OR,"Jefferson County, Oregon",4358,2092,2266,41031,46366,48903,33375,42043,NA,36888,8583,2016,8962,1739,17545,3755,"Jefferson County, Oregon(6,10)",50.9,14,"Jefferson County, Oregon",43.2,11,stable,22666,41,31,43.2,50.9
OR,"Josephine County, Oregon",16627,8447,8180,41033,37665,37988,43750,60074,NA,34104,34548,5828,37702,4663,72250,10491,"Josephine County, Oregon(6,10)",72.1,104,"Josephine County, Oregon",56.9,83,stable,84745,41,33,56.9,72.1
OR,"Klamath County, Oregon",12542,5452,7090,41035,40336,41083,14682,25313,105227,37708,28026,4452,28850,4124,56876,8576,"Klamath County, Oregon(6,10)",60.3,56,"Klamath County, Oregon",47.7,44,stable,66016,41,35,47.7,60.3
OR,"Lake County, Oregon",1365,663,702,41037,32369,33559,NA,19276,NA,29018,3203,540,3147,471,6350,1011,"Lake County, Oregon(6,10)",47,6,"Lake County, Oregon",33.3,4,falling,7829,41,37,33.3,47
OR,"Lane County, Oregon",70308,34709,35599,41039,44103,45046,28998,38869,32816,37962,150317,24192,161782,19249,312099,43441,"Lane County, Oregon(6,10)",53.9,237,"Lane County, Oregon",45.3,200,falling,362895,41,39,45.3,53.9
OR,"Lincoln County, Oregon",7754,3580,4174,41041,42101,42464,NA,33036,31875,40511,18568,3765,20081,3652,38649,7417,"Lincoln County, Oregon(6,10)",74.4,60,"Lincoln County, Oregon",58.9,47,falling,47038,41,41,58.9,74.4
OR,"Linn County, Oregon",22201,9995,12206,41043,45644,45963,NA,23125,72702,30333,50776,7628,53255,6574,104031,14202,"Linn County, Oregon(6,10)",71.3,106,"Linn County, Oregon",53.4,79,falling,120547,41,43,53.4,71.3
OR,"Malheur County, Oregon",6865,2879,3986,41045,35418,35547,NA,55833,40333,31447,11227,2206,11663,2105,22890,4311,"Malheur County, Oregon(6,10)",54,20,"Malheur County, Oregon",41.5,15,stable,30380,41,45,41.5,54
OR,"Marion County, Oregon",57846,26573,31273,41047,48432,50425,28841,33357,45974,39243,131443,24315,141525,20041,272968,44356,"Marion County, Oregon(6,10)",66.1,227,"Marion County, Oregon",45.9,157,falling,330700,41,47,45.9,66.1
OR,"Morrow County, Oregon",1844,862,982,41049,50918,51045,NA,NA,NA,46196,5057,741,4632,766,9689,1507,"Morrow County, Oregon(6,10)",62.3,8,"Morrow County, Oregon",53.5,7,falling,11190,41,49,53.5,62.3
OR,"Multnomah County, Oregon",136472,64213,72259,41051,54102,57449,27045,32500,52622,39321,323119,53210,345432,41447,668551,94657,"Multnomah County, Oregon(6,10)",62.2,432,"Multnomah County, Oregon",47.5,327,falling,790294,41,51,47.5,62.2
OR,"Polk County, Oregon",12270,5616,6654,41053,52821,54652,NA,32212,35682,51414,32708,4268,36242,3666,68950,7934,"Polk County, Oregon(6,10)",52.1,48,"Polk County, Oregon",38.3,36,falling,79391,41,53,38.3,52.1
OR,"Sherman County, Oregon",386,170,216,41055,38362,38879,NA,NA,NA,NA,704,199,766,126,1470,325,"Sherman County, Oregon(6,10)",*,3 or fewer,"Sherman County, Oregon",*,*,**,1680,41,55,NA,NA
OR,"Tillamook County, Oregon",4310,2086,2224,41057,42581,42794,NA,NA,79457,29500,10705,1559,10946,1557,21651,3116,"Tillamook County, Oregon(6,10)",63.6,27,"Tillamook County, Oregon",44,19,stable,25653,41,57,44,63.6
OR,"Umatilla County, Oregon",12733,5516,7217,41059,48101,49732,NA,30594,75595,42763,30466,5561,31784,4760,62250,10321,"Umatilla County, Oregon(6,10)",58,48,"Umatilla County, Oregon",45.1,37,falling,76531,41,59,45.1,58
OR,"Union County, Oregon",4641,1955,2686,41061,43822,44375,NA,54063,NA,33466,10846,1648,11547,1416,22393,3064,"Union County, Oregon(6,10)",44.7,15,"Union County, Oregon",41.7,15,stable,25790,41,61,41.7,44.7
OR,"Wallowa County, Oregon",1033,492,541,41063,40581,40625,19375,NA,NA,40750,2903,428,3121,311,6024,739,"Wallowa County, Oregon(6,10)",46.3,6,"Wallowa County, Oregon",35.5,4,**,6856,41,63,35.5,46.3
OR,"Wasco County, Oregon",4015,1812,2203,41065,43422,43695,NA,52031,39886,41149,10397,1964,11059,1641,21456,3605,"Wasco County, Oregon(6,10)",74.1,26,"Wasco County, Oregon",51.7,18,stable,25775,41,65,51.7,74.1
OR,"Washington County, Oregon",64861,29554,35307,41067,66754,67279,61752,51701,85141,44554,238347,34065,251792,28520,490139,62585,"Washington County, Oregon(6,10)",48,231,"Washington County, Oregon",35.1,167,falling,574326,41,67,35.1,48
OR,"Wheeler County, Oregon",250,107,143,41069,33487,33750,NA,NA,NA,59063,609,40,614,76,1223,116,"Wheeler County, Oregon(6,10)",*,3 or fewer,"Wheeler County, Oregon",*,*,**,1358,41,69,NA,NA
OR,"Yamhill County, Oregon",15877,7131,8746,41071,53423,55047,35625,24688,42619,42816,42081,6619,45550,4735,87631,11354,"Yamhill County, Oregon(6,10)",65.2,73,"Yamhill County, Oregon",44.7,50,falling,102659,41,71,44.7,65.2
PA,"Adams County, Pennsylvania",8715,3721,4994,42001,60356,61388,32255,NA,43333,33977,45267,4419,46924,3839,92191,8258,"Adams County, Pennsylvania(6,10)",59.2,79,"Adams County, Pennsylvania",41.5,55,falling,102295,42,1,41.5,59.2
PA,"Allegheny County, Pennsylvania",155874,67353,88521,42003,53040,57898,27238,31098,61044,43257,536490,48058,596998,35491,1133488,83549,"Allegheny County, Pennsylvania(6,10)",72.5,1193,"Allegheny County, Pennsylvania",51.3,862,falling,1230459,42,3,51.3,72.5
PA,"Armstrong County, Pennsylvania",8738,3962,4776,42005,44942,44992,40000,48125,NA,44107,30637,2828,31315,2661,61952,5489,"Armstrong County, Pennsylvania(6,10)",66.4,67,"Armstrong County, Pennsylvania",46.4,48,falling,67052,42,5,46.4,66.4
PA,"Beaver County, Pennsylvania",19888,8582,11306,42007,50581,52350,28447,NA,53750,51067,75565,5976,81562,5378,157127,11354,"Beaver County, Pennsylvania(6,10)",76.5,192,"Beaver County, Pennsylvania",49.7,129,falling,168871,42,7,49.7,76.5
PA,"Bedford County, Pennsylvania",6643,2986,3657,42009,45930,46059,NA,45547,51103,37431,21515,2699,21871,2457,43386,5156,"Bedford County, Pennsylvania(6,10)",51,37,"Bedford County, Pennsylvania",41.2,30,stable,48586,42,9,41.2,51
PA,"Berks County, Pennsylvania",56855,25575,31280,42011,55936,59459,31141,35042,71438,27558,179872,20953,191095,17231,370967,38184,"Berks County, Pennsylvania(6,10)",64.1,316,"Berks County, Pennsylvania",42.3,211,falling,415271,42,11,42.3,64.1
PA,"Blair County, Pennsylvania",18548,8198,10350,42013,43981,44283,30833,NA,73409,51420,55111,5728,59618,4406,114729,10134,"Blair County, Pennsylvania(6,10)",66.3,119,"Blair County, Pennsylvania",43.9,79,falling,125593,42,13,43.9,66.3
PA,"Bradford County, Pennsylvania",8336,3681,4655,42015,48987,48742,NA,NA,37679,56111,26927,3428,28330,2923,55257,6351,"Bradford County, Pennsylvania(6,10)",70.7,63,"Bradford County, Pennsylvania",50.2,45,stable,61281,42,15,50.2,70.7
PA,"Bucks County, Pennsylvania",36868,15318,21550,42017,77568,78570,46945,76107,108482,56197,283543,20263,300110,16531,583653,36794,"Bucks County, Pennsylvania(6,10)",62.5,487,"Bucks County, Pennsylvania",43.9,340,falling,627367,42,17,43.9,62.5
PA,"Butler County, Pennsylvania",16325,7113,9212,42019,60934,60823,47697,NA,110260,55694,84451,5945,88136,5118,172587,11063,"Butler County, Pennsylvania(6,10)",61.4,143,"Butler County, Pennsylvania",48.9,114,stable,186818,42,19,48.9,61.4
PA,"Cambria County, Pennsylvania",20011,8513,11498,42021,42107,43150,14837,NA,NA,32171,59888,5256,65635,4046,125523,9302,"Cambria County, Pennsylvania(6,10)",56.7,119,"Cambria County, Pennsylvania",43.7,95,falling,136411,42,21,43.7,56.7
PA,"Cameron County, Pennsylvania",626,217,409,42023,39897,39880,NA,NA,NA,NA,2224,193,2302,105,4526,298,"Cameron County, Pennsylvania(6,10)",60.6,5,"Cameron County, Pennsylvania",*,*,*,4732,42,23,NA,60.6
PA,"Carbon County, Pennsylvania",6909,2993,3916,42025,49973,50489,34761,NA,NA,41250,28504,2939,29761,2620,58265,5559,"Carbon County, Pennsylvania(6,10)",72.7,68,"Carbon County, Pennsylvania",53.4,50,stable,63960,42,25,53.4,72.7
PA,"Centre County, Pennsylvania",27217,14043,13174,42027,52186,54551,33065,15278,29250,34652,73881,5854,70268,4384,144149,10238,"Centre County, Pennsylvania(6,10)",53.1,77,"Centre County, Pennsylvania",37.9,56,falling,160580,42,27,37.9,53.1
PA,"Chester County, Pennsylvania",35053,15855,19198,42029,85976,87386,48570,98106,127414,51662,226928,20920,240899,16180,467827,37100,"Chester County, Pennsylvania(6,10)",54,301,"Chester County, Pennsylvania",39.4,219,falling,515939,42,29,39.4,54
PA,"Clarion County, Pennsylvania",6881,3045,3836,42031,42536,43024,22989,NA,NA,NA,16960,2041,18309,1721,35269,3762,"Clarion County, Pennsylvania(6,10)",59.2,31,"Clarion County, Pennsylvania",45.1,23,stable,39498,42,31,45.1,59.2
PA,"Clearfield County, Pennsylvania",11306,5035,6271,42033,42257,42138,61122,60208,NA,NA,33960,3682,35154,3195,69114,6877,"Clearfield County, Pennsylvania(6,10)",60.3,69,"Clearfield County, Pennsylvania",45.6,53,stable,80994,42,33,45.6,60.3
PA,"Clinton County, Pennsylvania",6086,2474,3612,42035,45078,45425,NA,41250,NA,NA,16748,2119,18306,1834,35054,3953,"Clinton County, Pennsylvania(6,10)",67.7,34,"Clinton County, Pennsylvania",57.3,29,stable,39441,42,35,57.3,67.7
PA,"Columbia County, Pennsylvania",10067,4475,5592,42037,45374,46253,30915,14875,30163,43893,29360,2388,32437,1957,61797,4345,"Columbia County, Pennsylvania(6,10)",58,50,"Columbia County, Pennsylvania",43.7,38,stable,66672,42,37,43.7,58
PA,"Crawford County, Pennsylvania",12321,5698,6623,42039,44579,45278,21106,16731,21944,26471,36696,5586,38231,5244,74927,10830,"Crawford County, Pennsylvania(6,10)",67.5,81,"Crawford County, Pennsylvania",54,64,stable,86484,42,39,54,67.5
PA,"Cumberland County, Pennsylvania",19984,8850,11134,42041,61820,62265,36677,NA,77500,41218,105040,9174,113648,7226,218688,16400,"Cumberland County, Pennsylvania(6,10)",56.8,172,"Cumberland County, Pennsylvania",40,123,falling,246338,42,41,40,56.8
PA,"Dauphin County, Pennsylvania",36269,16243,20026,42043,53754,59990,36515,34125,57106,33802,115148,13772,127773,11033,242921,24805,"Dauphin County, Pennsylvania(6,10)",66.7,210,"Dauphin County, Pennsylvania",45.1,144,falling,272983,42,43,45.1,66.7
PA,"Delaware County, Pennsylvania",57202,25013,32189,42045,65123,74867,40613,44766,71357,38914,241202,23418,269945,19730,511147,43148,"Delaware County, Pennsylvania(6,10)",70.8,468,"Delaware County, Pennsylvania",52.7,350,falling,563894,42,45,52.7,70.8
PA,"Elk County, Pennsylvania",2721,1090,1631,42047,46671,46601,NA,NA,NA,100365,14208,1204,14844,791,29052,1995,"Elk County, Pennsylvania(6,10)",65.8,32,"Elk County, Pennsylvania",54.2,27,stable,30872,42,47,54.2,65.8
PA,"Erie County, Pennsylvania",44595,19834,24761,42049,45971,48290,24473,25658,31455,19381,121595,12453,131087,9475,252682,21928,"Erie County, Pennsylvania(6,10)",66.5,225,"Erie County, Pennsylvania",48.7,164,falling,278045,42,49,48.7,66.5
PA,"Fayette County, Pennsylvania",25282,10838,14444,42051,39636,40678,20456,NA,48326,27262,57134,6460,62630,5263,119764,11723,"Fayette County, Pennsylvania(6,10)",77.5,151,"Fayette County, Pennsylvania",59.9,119,stable,133628,42,51,59.9,77.5
PA,"Forest County, Pennsylvania",523,245,278,42053,35533,35321,NA,NA,135208,33333,1618,95,1800,156,3418,251,"Forest County, Pennsylvania(6,10)",68.6,8,"Forest County, Pennsylvania",68,8,stable,7410,42,53,68,68.6
PA,"Franklin County, Pennsylvania",17554,7644,9910,42055,53916,55109,30214,28688,57560,38934,63891,10065,68419,8597,132310,18662,"Franklin County, Pennsylvania(6,10)",58.5,116,"Franklin County, Pennsylvania",44.8,89,stable,153638,42,55,44.8,58.5
PA,"Fulton County, Pennsylvania",1779,763,1016,42057,48311,49088,21250,NA,NA,28250,6665,725,6698,562,13363,1287,"Fulton County, Pennsylvania(6,10)",54.3,11,"Fulton County, Pennsylvania",49.1,10,stable,14629,42,57,49.1,54.3
PA,"Greene County, Pennsylvania",4672,1970,2702,42059,46661,47138,35000,NA,NA,NA,14997,1423,16705,1409,31702,2832,"Greene County, Pennsylvania(6,10)",84.2,42,"Greene County, Pennsylvania",60,29,stable,37519,42,59,60,84.2
PA,"Huntingdon County, Pennsylvania",5578,2342,3236,42061,44396,44471,NA,NA,31250,37188,18556,2031,19914,1550,38470,3581,"Huntingdon County, Pennsylvania(6,10)",58.4,36,"Huntingdon County, Pennsylvania",45.7,29,stable,45668,42,61,45.7,58.4
PA,"Indiana County, Pennsylvania",14176,6724,7452,42063,45195,45305,40556,NA,NA,36250,37802,5238,38940,4362,76742,9600,"Indiana County, Pennsylvania(6,10)",52.9,59,"Indiana County, Pennsylvania",36.8,42,falling,86966,42,63,36.8,52.9
PA,"Jefferson County, Pennsylvania",6414,2841,3573,42065,42903,43147,NA,NA,53750,30833,19527,2451,19928,2305,39455,4756,"Jefferson County, Pennsylvania(6,10)",66.1,43,"Jefferson County, Pennsylvania",41.4,27,stable,44430,42,65,41.4,66.1
PA,"Juniata County, Pennsylvania",3245,1410,1835,42067,47398,47564,NA,NA,2499,41184,10386,1917,10615,1643,21001,3560,"Juniata County, Pennsylvania(6,10)",54.7,18,"Juniata County, Pennsylvania",43,14,stable,24737,42,67,43,54.7
PA,"Lackawanna County, Pennsylvania",30447,13104,17343,42069,46271,46849,31192,31625,45169,26552,91401,9669,101629,6991,193030,16660,"Lackawanna County, Pennsylvania(6,10)",70.4,208,"Lackawanna County, Pennsylvania",47.5,144,stable,211917,42,69,47.5,70.4
PA,"Lancaster County, Pennsylvania",55372,25250,30122,42071,57721,59790,33793,43304,70479,32206,221257,34798,235699,31456,456956,66254,"Lancaster County, Pennsylvania(6,10)",53.3,340,"Lancaster County, Pennsylvania",38.5,249,falling,536624,42,71,38.5,53.3
PA,"Lawrence County, Pennsylvania",13192,5770,7422,42073,44571,45877,18028,NA,98750,40515,38993,3672,41997,3459,80990,7131,"Lawrence County, Pennsylvania(6,10)",71.3,95,"Lawrence County, Pennsylvania",52.1,71,stable,88082,42,73,52.1,71.3
PA,"Lebanon County, Pennsylvania",14922,6555,8367,42075,55499,57224,36766,112566,72616,35560,57116,8512,61657,6814,118773,15326,"Lebanon County, Pennsylvania(6,10)",65.3,120,"Lebanon County, Pennsylvania",49.8,92,stable,137067,42,75,49.8,65.3
PA,"Lehigh County, Pennsylvania",45488,19230,26258,42077,56117,58751,34913,49444,91266,35773,151765,19454,165135,15567,316900,35021,"Lehigh County, Pennsylvania(6,10)",63.6,271,"Lehigh County, Pennsylvania",41,178,falling,360685,42,77,41,63.6
PA,"Luzerne County, Pennsylvania",48822,21579,27243,42079,45897,47331,21658,13047,64508,29652,137597,14632,148186,11958,285783,26590,"Luzerne County, Pennsylvania(6,10)",68.7,308,"Luzerne County, Pennsylvania",46.1,210,stable,318449,42,79,46.1,68.7
PA,"Lycoming County, Pennsylvania",16150,7164,8986,42081,47313,48604,26579,NA,82188,26250,51054,5422,52534,4512,103588,9934,"Lycoming County, Pennsylvania(6,10)",67.1,101,"Lycoming County, Pennsylvania",51,78,stable,116048,42,81,51,67.1
PA,"McKean County, Pennsylvania",6830,3230,3600,42083,43965,44175,NA,NA,NA,32353,18718,1718,18801,1542,37519,3260,"McKean County, Pennsylvania(6,10)",68.1,39,"McKean County, Pennsylvania",50.2,30,falling,42412,42,83,50.2,68.1
PA,"Mercer County, Pennsylvania",14549,6345,8204,42085,44156,45735,25910,NA,67000,29262,48461,5240,53276,4406,101737,9646,"Mercer County, Pennsylvania(6,10)",66.9,110,"Mercer County, Pennsylvania",50.6,86,stable,114234,42,85,50.6,66.9
PA,"Mifflin County, Pennsylvania",7216,3249,3967,42087,41288,41371,NA,NA,NA,NA,19174,3604,20046,3293,39220,6897,"Mifflin County, Pennsylvania(6,10)",70.4,48,"Mifflin County, Pennsylvania",52,36,stable,46500,42,87,52,70.4
PA,"Monroe County, Pennsylvania",20702,9712,10990,42089,57365,57031,59221,61563,80575,56912,71747,10430,76082,8624,147829,19054,"Monroe County, Pennsylvania(6,10)",72.5,139,"Monroe County, Pennsylvania",55,103,stable,166397,42,89,55,72.5
PA,"Montgomery County, Pennsylvania",52330,22642,29688,42091,80675,83652,53994,64286,87743,56152,361453,25180,392043,20908,753496,46088,"Montgomery County, Pennsylvania(6,10)",56.8,569,"Montgomery County, Pennsylvania",40.4,408,stable,819264,42,91,40.4,56.8
PA,"Montour County, Pennsylvania",1749,722,1027,42093,54648,53397,NA,NA,80375,NA,7936,723,8717,523,16653,1246,"Montour County, Pennsylvania(6,10)",56.1,15,"Montour County, Pennsylvania",32,8,stable,18557,42,93,32,56.1
PA,"Northampton County, Pennsylvania",27294,11982,15312,42095,60972,62375,44719,29604,80378,40092,132436,12987,141524,9699,273960,22686,"Northampton County, Pennsylvania(6,10)",64.7,249,"Northampton County, Pennsylvania",45.5,177,falling,300813,42,95,45.5,64.7
PA,"Northumberland County, Pennsylvania",12279,5998,6281,42097,42406,42540,25121,NA,73050,31435,39185,4548,41667,4065,80852,8613,"Northumberland County, Pennsylvania(6,10)",66.3,91,"Northumberland County, Pennsylvania",52.4,73,stable,93246,42,97,52.4,66.3
PA,"Perry County, Pennsylvania",4217,1783,2434,42099,57177,57520,27292,49000,NA,45455,19945,2762,20190,2275,40135,5037,"Perry County, Pennsylvania(6,10)",71.8,41,"Perry County, Pennsylvania",54.1,30,stable,45685,42,99,54.1,71.8
PA,"Philadelphia County, Pennsylvania",399352,178789,220563,42101,38253,50895,30180,25885,39091,27945,612194,114397,726984,87190,1339178,201587,"Philadelphia County, Pennsylvania(6,10)",81.5,1260,"Philadelphia County, Pennsylvania",58.3,903,falling,1567442,42,101,58.3,81.5
PA,"Pike County, Pennsylvania",5532,2403,3129,42103,60180,59775,69395,NA,120227,56642,25086,2848,25903,2381,50989,5229,"Pike County, Pennsylvania(6,10)",64.5,52,"Pike County, Pennsylvania",41.2,32,stable,55949,42,103,41.2,64.5
PA,"Potter County, Pennsylvania",2570,1124,1446,42105,40654,40687,37500,41389,NA,26250,7682,900,7666,898,15348,1798,"Potter County, Pennsylvania(6,10)",79.8,22,"Potter County, Pennsylvania",56.6,15,stable,17093,42,105,56.6,79.8
PA,"Schuylkill County, Pennsylvania",18278,8099,10179,42107,45535,45908,24259,8954,54432,33705,61870,6938,64964,5868,126834,12806,"Schuylkill County, Pennsylvania(6,10)",68.1,144,"Schuylkill County, Pennsylvania",52.8,114,falling,144590,42,107,52.8,68.1
PA,"Snyder County, Pennsylvania",4077,1683,2394,42109,49917,50203,NA,NA,NA,31563,16547,3112,17299,2766,33846,5878,"Snyder County, Pennsylvania(6,10)",50.4,25,"Snyder County, Pennsylvania",38.2,19,stable,40444,42,109,38.2,50.4
PA,"Somerset County, Pennsylvania",9074,3689,5385,42111,44587,44718,NA,53594,NA,37083,32134,3445,33368,2942,65502,6387,"Somerset County, Pennsylvania(6,10)",48.5,56,"Somerset County, Pennsylvania",37.1,43,stable,75522,42,111,37.1,48.5
PA,"Sullivan County, Pennsylvania",802,459,343,42113,44189,44342,NA,NA,NA,17050,2854,366,2758,213,5612,579,"Sullivan County, Pennsylvania(6,10)",69.3,8,"Sullivan County, Pennsylvania",45.9,6,stable,6328,42,113,45.9,69.3
PA,"Susquehanna County, Pennsylvania",5455,2517,2938,42115,50477,50628,60568,NA,NA,38935,18579,2615,18736,2134,37315,4749,"Susquehanna County, Pennsylvania(6,10)",53.6,35,"Susquehanna County, Pennsylvania",43.2,27,stable,41666,42,115,43.2,53.6
PA,"Tioga County, Pennsylvania",5891,2553,3338,42117,46494,46561,40833,NA,NA,53438,18480,2352,18945,2094,37425,4446,"Tioga County, Pennsylvania(6,10)",69.6,41,"Tioga County, Pennsylvania",44.5,27,stable,41877,42,117,44.5,69.6
PA,"Union County, Pennsylvania",4554,1984,2570,42119,49803,49615,NA,NA,53750,48236,17003,2494,17874,2024,34877,4518,"Union County, Pennsylvania(6,10)",57.6,30,"Union County, Pennsylvania",36.8,20,stable,44954,42,119,36.8,57.6
PA,"Venango County, Pennsylvania",8123,3615,4508,42121,43644,44128,22917,28500,30357,NA,23455,2613,25029,2049,48484,4662,"Venango County, Pennsylvania(6,10)",74.7,60,"Venango County, Pennsylvania",56.5,46,stable,53119,42,121,56.5,74.7
PA,"Warren County, Pennsylvania",4891,2209,2682,42123,44020,44145,NA,18750,158472,40833,18265,1861,18589,1539,36854,3400,"Warren County, Pennsylvania(6,10)",59.9,38,"Warren County, Pennsylvania",48.3,31,falling,40396,42,123,48.3,59.9
PA,"Washington County, Pennsylvania",21074,9161,11913,42125,56450,56965,28359,9444,112118,56910,93215,7837,99622,5900,192837,13737,"Washington County, Pennsylvania(6,10)",68.2,201,"Washington County, Pennsylvania",51.8,156,falling,208261,42,125,51.8,68.2
PA,"Wayne County, Pennsylvania",6164,2836,3328,42127,49919,49665,70000,NA,139063,37174,21793,2342,22210,1717,44003,4059,"Wayne County, Pennsylvania(6,10)",64.4,51,"Wayne County, Pennsylvania",48.3,39,stable,51198,42,127,48.3,64.4
PA,"Westmoreland County, Pennsylvania",36758,15792,20966,42129,52247,52821,26907,40875,80903,33179,161502,12108,173372,9949,334874,22057,"Westmoreland County, Pennsylvania(6,10)",70.5,387,"Westmoreland County, Pennsylvania",48.5,271,falling,357956,42,129,48.5,70.5
PA,"Wyoming County, Pennsylvania",3030,1313,1717,42131,51004,51191,NA,NA,NA,42000,12674,1311,12815,1103,25489,2414,"Wyoming County, Pennsylvania(6,10)",77.1,29,"Wyoming County, Pennsylvania",51.5,20,stable,27800,42,131,51.5,77.1
PA,"York County, Pennsylvania",46124,19823,26301,42133,58269,60022,40535,48542,64840,31611,193984,20254,205039,15547,399023,35801,"York County, Pennsylvania(6,10)",67.2,353,"York County, Pennsylvania",46,240,falling,442867,42,133,46,67.2
RI,"Bristol County, Rhode Island",3396,1458,1938,44001,72458,72815,NA,NA,75000,63583,21668,1527,23909,1403,45577,2930,"Bristol County, Rhode Island(6,10)",54.5,37,"Bristol County, Rhode Island",38.8,27,falling,49084,44,1,38.8,54.5
RI,"Kent County, Rhode Island",13763,5821,7942,44003,64383,65089,46339,30882,72306,49607,73271,5936,79937,4404,153208,10340,"Kent County, Rhode Island(6,10)",68.9,150,"Kent County, Rhode Island",52.6,116,falling,164801,44,3,52.6,68.9
RI,"Newport County, Rhode Island",8005,3159,4846,44005,69526,72063,35324,7721,64632,36956,34929,3532,38696,2747,73625,6279,"Newport County, Rhode Island(6,10)",60.1,70,"Newport County, Rhode Island",42.2,50,falling,82423,44,5,42.2,60.1
RI,"Providence County, Rhode Island",107120,47085,60035,44007,49743,54148,35635,25581,52668,29084,259880,39761,291105,29863,550985,69624,"Providence County, Rhode Island(6,10)",72.7,503,"Providence County, Rhode Island",50.8,356,falling,633473,44,7,50.8,72.7
RI,"Washington County, Rhode Island",11939,5494,6445,44009,72807,74124,69850,29375,34773,55031,56838,3949,61538,3037,118376,6986,"Washington County, Rhode Island(6,10)",64.8,104,"Washington County, Rhode Island",45.9,74,falling,126517,44,9,45.9,64.8
SC,"Abbeville County, South Carolina",5471,2510,2961,45001,34799,39503,21304,NA,NA,49389,10557,1616,11107,1521,21664,3137,"Abbeville County, South Carolina(6,10)",68.1,24,"Abbeville County, South Carolina",57.6,20,stable,24932,45,1,57.6,68.1
SC,"Aiken County, South Carolina",29126,13078,16048,45003,45759,52351,31960,28438,49821,29596,66457,11763,73660,10259,140117,22022,"Aiken County, South Carolina(6,10)",58.5,122,"Aiken County, South Carolina",44,91,falling,165829,45,3,44,58.5
SC,"Allendale County, South Carolina",2537,1164,1373,45005,25327,41034,22265,NA,NA,38583,3288,870,3874,725,7162,1595,"Allendale County, South Carolina(6,10)",61.7,8,"Allendale County, South Carolina",50.1,6,stable,9433,45,5,50.1,61.7
SC,"Anderson County, South Carolina",30915,13201,17714,45007,42143,45829,27256,NA,34816,40913,77981,13678,84828,13434,162809,27112,"Anderson County, South Carolina(6,10)",69.6,166,"Anderson County, South Carolina",52.5,124,falling,194692,45,7,52.5,69.6
SC,"Bamberg County, South Carolina",4077,2090,1987,45009,31314,45490,22015,NA,NA,NA,5833,1422,6560,1456,12393,2878,"Bamberg County, South Carolina(6,10)",59,13,"Bamberg County, South Carolina",54.5,11,stable,14880,45,9,54.5,59
SC,"Barnwell County, South Carolina",5819,2287,3532,45011,34336,44746,22500,30962,NA,NA,8393,1764,10059,1590,18452,3354,"Barnwell County, South Carolina(6,10)",59.5,15,"Barnwell County, South Carolina",56.2,15,falling,21725,45,11,56.2,59.5
SC,"Beaufort County, South Carolina",21221,9021,12200,45013,57048,65213,31229,37011,50397,42350,65203,13044,74251,11394,139454,24438,"Beaufort County, South Carolina(6,10)",49,124,"Beaufort County, South Carolina",39,96,falling,179589,45,13,39,49
SC,"Berkeley County, South Carolina",26327,11742,14585,45015,52506,59883,37471,23250,60368,42668,76790,14687,82601,13959,159391,28646,"Berkeley County, South Carolina(6,10)",84.8,142,"Berkeley County, South Carolina",59.7,97,falling,202786,45,15,59.7,84.8
SC,"Calhoun County, South Carolina",2896,1389,1507,45017,43531,53496,30412,NA,NA,NA,5943,1245,6540,1110,12483,2355,"Calhoun County, South Carolina(6,10)",59.7,12,"Calhoun County, South Carolina",40,8,stable,14781,45,17,40,59.7
SC,"Charleston County, South Carolina",62119,26269,35850,45019,53437,66565,29012,25000,57008,38053,147518,27588,165993,24784,313511,52372,"Charleston County, South Carolina(6,10)",65.5,257,"Charleston County, South Carolina",45.7,177,falling,389262,45,19,45.7,65.5
SC,"Cherokee County, South Carolina",13093,5591,7502,45021,35389,40232,23805,11472,13571,34590,22852,4085,24214,4363,47066,8448,"Cherokee County, South Carolina(6,10)",87.7,56,"Cherokee County, South Carolina",57.9,38,stable,56194,45,21,57.9,87.7
SC,"Chester County, South Carolina",8734,3931,4803,45023,31914,40675,22845,92000,NA,36307,13333,2418,14555,2043,27888,4461,"Chester County, South Carolina(6,10)",77.4,32,"Chester County, South Carolina",61.8,25,stable,32267,45,23,61.8,77.4
SC,"Chesterfield County, South Carolina",11930,6027,5903,45025,32083,36565,24898,63750,95439,31630,18061,4230,20021,3415,38082,7645,"Chesterfield County, South Carolina(6,10)",81.2,45,"Chesterfield County, South Carolina",69.2,37,stable,46017,45,25,69.2,81.2
SC,"Clarendon County, South Carolina",8163,3623,4540,45027,33162,47509,21927,NA,NA,30735,12476,2754,14807,2550,27283,5304,"Clarendon County, South Carolina(6,10)",70,35,"Clarendon County, South Carolina",55.4,27,stable,33775,45,27,55.4,70
SC,"Colleton County, South Carolina",8340,3466,4874,45029,32804,39830,25033,NA,NA,32708,13977,3684,16615,3138,30592,6822,"Colleton County, South Carolina(6,10)",93.5,48,"Colleton County, South Carolina",73.9,38,stable,37731,45,29,73.9,93.5
SC,"Darlington County, South Carolina",15878,6580,9298,45031,35409,45652,24959,NA,69000,37014,26494,5130,30063,5479,56557,10609,"Darlington County, South Carolina(6,10)",72.4,62,"Darlington County, South Carolina",56.2,49,falling,67548,45,31,56.2,72.4
SC,"Dillon County, South Carolina",10502,4356,6146,45033,28938,33514,24378,14494,NA,31146,11823,2818,13869,2550,25692,5368,"Dillon County, South Carolina(6,10)",85.5,32,"Dillon County, South Carolina",73.6,27,stable,31234,45,33,73.6,85.5
SC,"Dorchester County, South Carolina",18737,7557,11180,45035,54901,61613,36841,33068,65929,36221,58873,9427,65555,8997,124428,18424,"Dorchester County, South Carolina(6,10)",70.6,89,"Dorchester County, South Carolina",50.5,61,falling,152478,45,35,50.5,70.6
SC,"Edgefield County, South Carolina",3896,1597,2299,45037,46637,58766,29944,NA,NA,NA,10071,1561,10803,1356,20874,2917,"Edgefield County, South Carolina(6,10)",58.5,18,"Edgefield County, South Carolina",40.1,11,stable,26514,45,37,40.1,58.5
SC,"Fairfield County, South Carolina",5566,2255,3311,45039,36004,46349,29073,NA,NA,37724,8822,2045,10276,1634,19098,3679,"Fairfield County, South Carolina(6,10)",57.9,18,"Fairfield County, South Carolina",50.7,16,stable,22747,45,39,50.7,57.9
SC,"Florence County, South Carolina",26802,11243,15559,45041,42080,51691,31343,NA,68587,40078,54653,9130,64203,8756,118856,17886,"Florence County, South Carolina(6,10)",72.8,115,"Florence County, South Carolina",56.3,87,falling,138900,45,41,56.3,72.8
SC,"Georgetown County, South Carolina",12557,5083,7474,45043,42835,55095,23386,NA,NA,24022,23043,5322,25907,5666,48950,10988,"Georgetown County, South Carolina(6,10)",59.2,57,"Georgetown County, South Carolina",54.4,51,stable,61298,45,43,54.4,59.2
SC,"Greenville County, South Carolina",72169,31335,40834,45045,50540,55728,30967,35703,63886,32197,191418,36038,210433,32540,401851,68578,"Greenville County, South Carolina(6,10)",64.6,324,"Greenville County, South Carolina",48.8,241,falling,491863,45,45,48.8,64.6
SC,"Greenwood County, South Carolina",15875,6825,9050,45047,37060,46363,22744,NA,NA,26611,26455,5937,30943,5161,57398,11098,"Greenwood County, South Carolina(6,10)",63.2,54,"Greenwood County, South Carolina",50.4,43,falling,69838,45,47,50.4,63.2
SC,"Hampton County, South Carolina",3963,1734,2229,45049,31410,44739,25693,133021,NA,61324,7981,1277,8585,1251,16566,2528,"Hampton County, South Carolina(6,10)",78.1,20,"Hampton County, South Carolina",54.2,14,stable,20049,45,49,54.2,78.1
SC,"Horry County, South Carolina",51988,23286,28702,45051,43299,45997,27800,46285,38530,32182,110502,30159,122928,25877,233430,56036,"Horry County, South Carolina(6,10)",74.7,286,"Horry County, South Carolina",58.5,219,falling,309199,45,51,58.5,74.7
SC,"Jasper County, South Carolina",6106,2888,3218,45053,37141,44091,27690,NA,36422,39732,9645,3107,10827,2293,20472,5400,"Jasper County, South Carolina(6,10)",51.9,14,"Jasper County, South Carolina",41.3,11,stable,27824,45,53,41.3,51.9
SC,"Kershaw County, South Carolina",10467,4672,5795,45055,43622,51569,27098,NA,NA,52782,25576,4545,27680,4370,53256,8915,"Kershaw County, South Carolina(6,10)",73.6,57,"Kershaw County, South Carolina",58.6,46,falling,63603,45,55,58.6,73.6
SC,"Lancaster County, South Carolina",14802,6340,8462,45057,44016,49124,28505,NA,68304,51886,31574,6691,35660,5498,67234,12189,"Lancaster County, South Carolina(6,10)",67.5,68,"Lancaster County, South Carolina",52.1,51,stable,85842,45,57,52.1,67.5
SC,"Laurens County, South Carolina",13395,5938,7457,45059,38515,41073,31427,NA,NA,31319,26436,5237,28520,5001,54956,10238,"Laurens County, South Carolina(6,10)",80.2,67,"Laurens County, South Carolina",61.6,52,stable,66623,45,59,61.6,80.2
SC,"Lee County, South Carolina",4663,2202,2461,45061,30954,45322,23019,NA,NA,NA,6869,1249,7676,1059,14545,2308,"Lee County, South Carolina(6,10)",73,17,"Lee County, South Carolina",63,14,stable,17896,45,61,63,73
SC,"Lexington County, South Carolina",38470,16614,21856,45063,53857,56968,38020,40893,64959,40926,113462,18221,123168,15916,236630,34137,"Lexington County, South Carolina(6,10)",68.5,196,"Lexington County, South Carolina",49.4,139,falling,281833,45,63,49.4,68.5
SC,"McCormick County, South Carolina",1681,741,940,45065,38712,52933,27585,NA,NA,NA,3739,490,4037,355,7776,845,"McCormick County, South Carolina(6,10)",67.4,13,"McCormick County, South Carolina",41.8,8,falling,9706,45,65,41.8,67.4
SC,"Marion County, South Carolina",8865,3480,5385,45067,29874,46372,21887,46161,85345,67938,11895,2774,14719,2576,26614,5350,"Marion County, South Carolina(6,10)",79.3,33,"Marion County, South Carolina",62.1,25,stable,31747,45,67,62.1,79.3
SC,"Marlboro County, South Carolina",7224,3108,4116,45069,30767,36947,26417,17969,37917,28689,9909,2000,11330,1652,21239,3652,"Marlboro County, South Carolina(6,10)",87.2,29,"Marlboro County, South Carolina",70.7,23,stable,27494,45,69,70.7,87.2
SC,"Newberry County, South Carolina",6436,2717,3719,45071,40127,49982,27778,NA,83631,27612,15554,2451,17302,1876,32856,4327,"Newberry County, South Carolina(6,10)",58.5,29,"Newberry County, South Carolina",52.9,26,stable,38012,45,71,52.9,58.5
SC,"Oconee County, South Carolina",14897,6520,8377,45073,41237,42444,32692,52813,49615,30482,30610,5988,32900,4886,63510,10874,"Oconee County, South Carolina(6,10)",68.8,75,"Oconee County, South Carolina",55.1,59,stable,75713,45,73,55.1,68.8
SC,"Orangeburg County, South Carolina",20600,9050,11550,45075,34218,42791,28803,23516,53864,28301,33986,8236,40299,7329,74285,15565,"Orangeburg County, South Carolina(6,10)",63.3,71,"Orangeburg County, South Carolina",48,54,stable,89208,45,75,48,63.3
SC,"Pickens County, South Carolina",22545,10766,11779,45077,41459,42360,31948,40037,31250,34596,51713,7705,52787,7184,104500,14889,"Pickens County, South Carolina(6,10)",74,99,"Pickens County, South Carolina",51.5,69,stable,121691,45,77,51.5,74
SC,"Richland County, South Carolina",62611,26738,35873,45079,49131,61259,37214,34968,53458,45717,151728,23127,176936,21861,328664,44988,"Richland County, South Carolina(6,10)",70.1,242,"Richland County, South Carolina",49.3,167,falling,407051,45,79,49.3,70.1
SC,"Saluda County, South Carolina",4062,1813,2249,45081,38827,48736,24643,2499,NA,30647,7809,2323,8061,1629,15870,3952,"Saluda County, South Carolina(6,10)",55.1,14,"Saluda County, South Carolina",49.6,13,falling,20053,45,81,49.6,55.1
SC,"Spartanburg County, South Carolina",49665,21832,27833,45083,43907,48916,30228,35163,56763,40947,116394,21970,128890,19821,245284,41791,"Spartanburg County, South Carolina(6,10)",73.1,241,"Spartanburg County, South Carolina",55,179,falling,297302,45,83,55,73.1
SC,"Sumter County, South Carolina",18943,8146,10797,45085,41332,50229,30599,43485,45332,42980,41053,7699,47931,7265,88984,14964,"Sumter County, South Carolina(6,10)",72,84,"Sumter County, South Carolina",49,57,stable,107480,45,85,49,72
SC,"Union County, South Carolina",5605,2257,3348,45087,34033,41221,21953,NA,NA,28250,11273,1890,12828,1661,24101,3551,"Union County, South Carolina(6,10)",94.2,36,"Union County, South Carolina",67.7,26,stable,27777,45,87,67.7,94.2
SC,"Williamsburg County, South Carolina",9349,3950,5399,45089,28297,44696,22760,NA,2499,NA,11827,2608,14320,2656,26147,5264,"Williamsburg County, South Carolina(6,10)",66.3,29,"Williamsburg County, South Carolina",59.4,26,stable,32535,45,89,59.4,66.3
SC,"York County, South Carolina",31814,13652,18162,45091,54117,61048,32553,33452,70469,50644,100411,14632,109930,13654,210341,28286,"York County, South Carolina(6,10)",66.8,157,"York County, South Carolina",54,124,stable,251195,45,91,54,66.8
SD,"Aurora County, South Dakota",223,105,118,46003,48750,49811,NA,NA,NA,45521,1228,120,1171,92,2399,212,"Aurora County, South Dakota(6,10)",96,4,"Aurora County, South Dakota",*,*,**,2733,46,3,NA,96
SD,"Beadle County, South Dakota",3708,1647,2061,46005,46267,46903,NA,NA,25938,26238,8284,702,7876,999,16160,1701,"Beadle County, South Dakota(6,10)",48.6,12,"Beadle County, South Dakota",30.7,8,stable,18372,46,5,30.7,48.6
SD,"Bennett County, South Dakota",1361,631,730,46007,42171,48589,30938,33836,NA,NA,1209,437,1419,333,2628,770,"Bennett County, South Dakota(6,10)",*,3 or fewer,"Bennett County, South Dakota",*,*,**,3423,46,7,NA,NA
SD,"Bon Homme County, South Dakota",576,268,308,46009,45254,45572,NA,NA,NA,25208,2563,127,2707,185,5270,312,"Bon Homme County, South Dakota(6,10)",55.7,6,"Bon Homme County, South Dakota",50.4,5,**,6985,46,9,50.4,55.7
SD,"Brookings County, South Dakota",4811,2411,2400,46011,50082,50600,48246,22885,45521,32049,15337,1441,14945,1191,30282,2632,"Brookings County, South Dakota(6,10)",53.5,14,"Brookings County, South Dakota",37.9,10,stable,33897,46,11,37.9,53.5
SD,"Brown County, South Dakota",3613,1635,1978,46013,53100,53486,NA,37424,NA,41821,16936,1375,17705,1494,34641,2869,"Brown County, South Dakota(6,10)",57.5,27,"Brown County, South Dakota",44.8,22,stable,38785,46,13,44.8,57.5
SD,"Brule County, South Dakota",789,351,438,46015,49531,50734,NA,38750,NA,NA,2230,329,2358,273,4588,602,"Brule County, South Dakota(6,10)",83,6,"Brule County, South Dakota",53.7,4,stable,5281,46,15,53.7,83
SD,"Buffalo County, South Dakota",711,362,349,46017,31163,49250,NA,27500,NA,NA,498,529,542,469,1040,998,"Buffalo County, South Dakota(6,10)",*,3 or fewer,"Buffalo County, South Dakota",*,*,**,2095,46,17,NA,NA
SD,"Butte County, South Dakota",1082,514,568,46019,41920,43065,NA,13862,NA,24688,4029,966,4329,836,8358,1802,"Butte County, South Dakota(6,10)",60.8,9,"Butte County, South Dakota",59.5,8,stable,10283,46,19,59.5,60.8
SD,"Campbell County, South Dakota",140,58,82,46021,45170,45909,NA,NA,NA,NA,702,29,757,60,1459,89,"Campbell County, South Dakota(6,10)",*,3 or fewer,"Campbell County, South Dakota",*,*,**,1397,46,21,NA,NA
SD,"Charles Mix County, South Dakota",1970,923,1047,46023,43109,50458,NA,25208,NA,37250,3578,909,3650,869,7228,1778,"Charles Mix County, South Dakota(6,10)",48.9,6,"Charles Mix County, South Dakota",34.5,4,stable,9383,46,23,34.5,48.9
SD,"Clark County, South Dakota",566,285,281,46025,49600,49550,NA,NA,NA,56146,1657,175,1603,126,3260,301,"Clark County, South Dakota(6,10)",*,3 or fewer,"Clark County, South Dakota",*,*,**,3659,46,25,NA,NA
SD,"Clay County, South Dakota",3255,1660,1595,46027,36608,38561,NA,NA,NA,16493,6070,851,6226,656,12296,1507,"Clay County, South Dakota(6,10)",61.4,7,"Clay County, South Dakota",51,6,stable,13964,46,27,51,61.4
SD,"Codington County, South Dakota",2806,1298,1508,46029,48912,49812,NA,50625,NA,40556,12669,1152,12462,1165,25131,2317,"Codington County, South Dakota(6,10)",49.4,16,"Codington County, South Dakota",45.2,15,stable,27939,46,29,45.2,49.4
SD,"Corson County, South Dakota",1865,907,958,46031,31676,48661,NA,19266,NA,NA,1558,565,1619,407,3177,972,"Corson County, South Dakota(6,10)",*,3 or fewer,"Corson County, South Dakota",*,*,**,4197,46,31,NA,NA
SD,"Custer County, South Dakota",850,373,477,46033,52218,53153,NA,39412,NA,2499,3586,437,3623,442,7209,879,"Custer County, South Dakota(6,10)",38.6,6,"Custer County, South Dakota",32.9,5,falling,8446,46,33,32.9,38.6
SD,"Davison County, South Dakota",2379,1314,1065,46035,49991,50733,NA,NA,NA,78784,8778,1039,9135,456,17913,1495,"Davison County, South Dakota(6,10)",64.2,17,"Davison County, South Dakota",48.3,13,stable,19858,46,35,48.3,64.2
SD,"Day County, South Dakota",1200,559,641,46037,39216,40633,NA,21500,NA,NA,2426,334,2393,305,4819,639,"Day County, South Dakota(6,10)",45,4,"Day County, South Dakota",43.6,5,stable,5539,46,37,43.6,45
SD,"Deuel County, South Dakota",330,160,170,46039,53152,52989,NA,NA,NA,73100,2086,138,1909,140,3995,278,"Deuel County, South Dakota(6,10)",48,3,"Deuel County, South Dakota",46.8,3,**,4333,46,39,46.8,48
SD,"Dewey County, South Dakota",1523,728,795,46041,37206,58875,NA,30184,NA,NA,1728,959,1860,987,3588,1946,"Dewey County, South Dakota(6,10)",82.2,3,"Dewey County, South Dakota",*,*,*,5685,46,41,NA,82.2
SD,"Douglas County, South Dakota",246,72,174,46043,52500,52594,NA,NA,NA,NA,1168,245,1283,181,2451,426,"Douglas County, South Dakota(6,10)",81.9,4,"Douglas County, South Dakota",*,*,**,2977,46,43,NA,81.9
SD,"Edmunds County, South Dakota",479,213,266,46045,56000,55000,NA,NA,NA,NA,1770,142,1888,97,3658,239,"Edmunds County, South Dakota(6,10)",*,3 or fewer,"Edmunds County, South Dakota",*,*,**,3999,46,45,NA,NA
SD,"Fall River County, South Dakota",1097,543,554,46047,45997,46376,NA,NA,NA,46389,2999,348,3005,351,6004,699,"Fall River County, South Dakota(6,10)",63.6,8,"Fall River County, South Dakota",55,7,stable,6867,46,47,55,63.6
SD,"Faulk County, South Dakota",373,244,129,46049,43679,43679,NA,NA,NA,NA,1135,88,1011,70,2146,158,"Faulk County, South Dakota(6,10)",*,3 or fewer,"Faulk County, South Dakota",*,*,**,2337,46,49,NA,NA
SD,"Grant County, South Dakota",582,228,354,46051,51272,51629,NA,NA,NA,33859,3334,406,3284,156,6618,562,"Grant County, South Dakota(6,10)",55.1,6,"Grant County, South Dakota",33.3,3,stable,7142,46,51,33.3,55.1
SD,"Gregory County, South Dakota",769,363,406,46053,37540,39345,NA,17500,NA,NA,1909,213,1848,206,3757,419,"Gregory County, South Dakota(6,10)",75.8,5,"Gregory County, South Dakota",57.3,4,stable,4201,46,53,57.3,75.8
SD,"Haakon County, South Dakota",343,181,162,46055,41518,41756,NA,NA,NA,NA,938,104,924,78,1862,182,"Haakon County, South Dakota(6,10)",*,3 or fewer,"Haakon County, South Dakota",*,*,**,1861,46,55,NA,NA
SD,"Hamlin County, South Dakota",424,176,248,46057,58602,58729,NA,NA,NA,53750,2741,245,2698,157,5439,402,"Hamlin County, South Dakota(6,10)",47.8,3,"Hamlin County, South Dakota",*,*,**,6047,46,57,NA,47.8
SD,"Hand County, South Dakota",271,138,133,46059,47163,46971,NA,NA,NA,NA,1529,163,1557,71,3086,234,"Hand County, South Dakota(6,10)",*,3 or fewer,"Hand County, South Dakota",*,*,**,3348,46,59,NA,NA
SD,"Hanson County, South Dakota",406,245,161,46061,60741,61157,NA,NA,NA,NA,1601,123,1553,106,3154,229,"Hanson County, South Dakota(6,10)",*,3 or fewer,"Hanson County, South Dakota",*,*,**,3385,46,61,NA,NA
SD,"Harding County, South Dakota",174,85,89,46063,52396,52569,NA,NA,NA,NA,612,57,586,50,1198,107,"Harding County, South Dakota(6,10)",*,3 or fewer,"Harding County, South Dakota",*,*,**,1267,46,63,NA,NA
SD,"Hughes County, South Dakota",1663,776,887,46065,59177,63888,NA,22260,NA,46458,7561,789,7576,567,15137,1356,"Hughes County, South Dakota(6,10)",52.1,10,"Hughes County, South Dakota",30.7,6,falling,17555,46,65,30.7,52.1
SD,"Hutchinson County, South Dakota",926,498,428,46067,45075,45869,NA,NA,NA,NA,3235,294,3261,193,6496,487,"Hutchinson County, South Dakota(6,10)",41.9,5,"Hutchinson County, South Dakota",31.8,4,stable,7301,46,67,31.8,41.9
SD,"Hyde County, South Dakota",168,74,94,46069,51776,50000,NA,74643,NA,NA,644,56,600,76,1244,132,"Hyde County, South Dakota(6,10)",*,3 or fewer,"Hyde County, South Dakota",*,*,**,1397,46,69,NA,NA
SD,"Jackson County, South Dakota",1059,511,548,46071,45074,50667,NA,36477,NA,NA,1213,368,1242,371,2455,739,"Jackson County, South Dakota(6,10)",*,3 or fewer,"Jackson County, South Dakota",*,*,**,3321,46,71,NA,NA
SD,"Jerauld County, South Dakota",176,67,109,46073,53125,54034,NA,NA,NA,21875,877,76,983,54,1860,130,"Jerauld County, South Dakota(6,10)",*,3 or fewer,"Jerauld County, South Dakota",*,*,**,1997,46,73,NA,NA
SD,"Jones County, South Dakota",89,49,40,46075,35972,37292,NA,NA,NA,NA,326,64,332,59,658,123,"Jones County, South Dakota(6,10)",*,3 or fewer,"Jones County, South Dakota",*,*,**,924,46,75,NA,NA
SD,"Kingsbury County, South Dakota",505,219,286,46077,53828,55139,NA,NA,NA,28958,2374,181,2323,141,4697,322,"Kingsbury County, South Dakota(6,10)",62.6,6,"Kingsbury County, South Dakota",45.5,4,stable,4990,46,77,45.5,62.6
SD,"Lake County, South Dakota",1732,766,966,46079,54535,54401,NA,NA,53365,NA,5612,476,5438,410,11050,886,"Lake County, South Dakota(6,10)",46,7,"Lake County, South Dakota",35.6,6,falling,12622,46,79,35.6,46
SD,"Lawrence County, South Dakota",3115,1219,1896,46081,45548,46120,NA,20139,77188,60337,10268,1828,10732,1570,21000,3398,"Lawrence County, South Dakota(6,10)",47.8,15,"Lawrence County, South Dakota",37.5,12,stable,24827,46,81,37.5,47.8
SD,"Lincoln County, South Dakota",2158,859,1299,46083,76094,76087,32546,80417,250001,127700,23479,1225,23552,1339,47031,2564,"Lincoln County, South Dakota(6,10)",48.9,18,"Lincoln County, South Dakota",33.8,12,stable,52849,46,83,33.8,48.9
SD,"Lyman County, South Dakota",775,360,415,46085,43030,50179,NA,31042,NA,NA,1540,469,1464,342,3004,811,"Lyman County, South Dakota(6,10)",*,3 or fewer,"Lyman County, South Dakota",*,*,**,3876,46,85,NA,NA
SD,"McCook County, South Dakota",467,218,249,46087,56954,56901,NA,61083,NA,NA,2512,236,2556,160,5068,396,"McCook County, South Dakota(6,10)",86,7,"McCook County, South Dakota",57.6,5,**,5599,46,87,57.6,86
SD,"McPherson County, South Dakota",478,306,172,46089,36375,35625,NA,NA,NA,NA,935,208,971,61,1906,269,"McPherson County, South Dakota(6,10)",*,3 or fewer,"McPherson County, South Dakota",*,*,**,2415,46,89,NA,NA
SD,"Marshall County, South Dakota",701,296,405,46091,51788,53031,NA,31328,NA,53750,2212,202,1946,276,4158,478,"Marshall County, South Dakota(6,10)",53.7,4,"Marshall County, South Dakota",48.5,3,**,4769,46,91,48.5,53.7
SD,"Meade County, South Dakota",2764,1272,1492,46093,52473,53750,41165,NA,NA,40112,11335,1390,10920,1420,22255,2810,"Meade County, South Dakota(6,10)",56.4,15,"Meade County, South Dakota",44.9,12,stable,26986,46,93,44.9,56.4
SD,"Mellette County, South Dakota",921,437,484,46095,30938,43365,NA,20556,NA,26458,733,290,867,162,1600,452,"Mellette County, South Dakota(6,10)",*,3 or fewer,"Mellette County, South Dakota",*,*,**,2050,46,95,NA,NA
SD,"Miner County, South Dakota",234,119,115,46097,44938,47813,NA,NA,NA,NA,1070,81,1019,94,2089,175,"Miner County, South Dakota(6,10)",88.3,4,"Miner County, South Dakota",*,*,**,2236,46,97,NA,88.3
SD,"Minnehaha County, South Dakota",20578,9155,11423,46099,53525,56604,28677,22367,49618,47646,78600,9208,81047,7340,159647,16548,"Minnehaha County, South Dakota(6,10)",65.3,110,"Minnehaha County, South Dakota",52.1,87,stable,185197,46,99,52.1,65.3
SD,"Moody County, South Dakota",910,441,469,46101,52446,53630,NA,40357,53625,35313,2765,439,2955,224,5720,663,"Moody County, South Dakota(6,10)",44.2,4,"Moody County, South Dakota",*,*,**,6430,46,101,NA,44.2
SD,"Pennington County, South Dakota",13079,5673,7406,46103,50890,52561,41284,19824,51544,42240,44048,6865,45946,6281,89994,13146,"Pennington County, South Dakota(6,10)",66.1,78,"Pennington County, South Dakota",46.9,55,falling,108702,46,103,46.9,66.1
SD,"Perkins County, South Dakota",396,193,203,46105,39773,41346,NA,14318,NA,64063,1314,183,1308,131,2622,314,"Perkins County, South Dakota(6,10)",*,3 or fewer,"Perkins County, South Dakota",*,*,**,3019,46,105,NA,NA
SD,"Potter County, South Dakota",255,141,114,46107,46081,46375,NA,NA,NA,NA,1000,78,1059,94,2059,172,"Potter County, South Dakota(6,10)",89,4,"Potter County, South Dakota",*,*,**,2320,46,107,NA,89
SD,"Roberts County, South Dakota",2031,969,1062,46109,48614,55478,NA,33295,NA,NA,4011,1062,4127,920,8138,1982,"Roberts County, South Dakota(6,10)",46.4,6,"Roberts County, South Dakota",34.9,5,stable,10311,46,109,34.9,46.4
SD,"Sanborn County, South Dakota",238,121,117,46111,50541,50331,NA,NA,NA,54792,1130,77,1005,73,2135,150,"Sanborn County, South Dakota(6,10)",*,3 or fewer,"Sanborn County, South Dakota",*,*,**,2355,46,111,NA,NA
SD,"Spink County, South Dakota",798,340,458,46115,48217,48483,NA,NA,NA,NA,3000,267,2865,288,5865,555,"Spink County, South Dakota(6,10)",48.8,5,"Spink County, South Dakota",46.2,5,**,6524,46,115,46.2,48.8
SD,"Stanley County, South Dakota",240,94,146,46117,56829,58788,NA,55231,NA,NA,1328,167,1350,117,2678,284,"Stanley County, South Dakota(6,10)",*,3 or fewer,"Stanley County, South Dakota",*,*,**,2954,46,117,NA,NA
SD,"Sully County, South Dakota",74,36,38,46119,60417,62292,NA,NA,NA,NA,712,111,600,46,1312,157,"Sully County, South Dakota(6,10)",*,3 or fewer,"Sully County, South Dakota",*,*,**,1426,46,119,NA,NA
SD,"Todd County, South Dakota",4471,2116,2355,46121,31128,47404,NA,23259,NA,23333,3268,1556,3624,1455,6892,3011,"Todd County, South Dakota(6,10)",*,3 or fewer,"Todd County, South Dakota",64.7,3,**,9959,46,121,64.7,NA
SD,"Tripp County, South Dakota",1212,535,677,46123,37153,41250,NA,19766,NA,NA,2333,379,2383,265,4716,644,"Tripp County, South Dakota(6,10)",42.6,4,"Tripp County, South Dakota",*,*,*,5434,46,123,NA,42.6
SD,"Turner County, South Dakota",761,305,456,46125,53378,53497,NA,2499,NA,NA,3818,305,3733,289,7551,594,"Turner County, South Dakota(6,10)",56.2,6,"Turner County, South Dakota",35.7,4,stable,8209,46,125,35.7,56.2
SD,"Union County, South Dakota",783,292,491,46127,64471,64358,NA,NA,NA,NA,6911,503,6929,379,13840,882,"Union County, South Dakota(6,10)",80.2,14,"Union County, South Dakota",44,8,falling,14909,46,127,44,80.2
SD,"Walworth County, South Dakota",650,241,409,46129,43221,42697,NA,NA,NA,46375,2297,304,2438,278,4735,582,"Walworth County, South Dakota(6,10)",47,5,"Walworth County, South Dakota",42.9,4,stable,5443,46,129,42.9,47
SD,"Yankton County, South Dakota",2993,1298,1695,46135,48176,48524,42440,NA,250001,37470,9303,1212,9798,833,19101,2045,"Yankton County, South Dakota(6,10)",61.4,18,"Yankton County, South Dakota",43.5,13,stable,22702,46,135,43.5,61.4
SD,"Ziebach County, South Dakota",1103,507,596,46137,35119,57813,NA,21920,NA,NA,958,433,1131,311,2089,744,"Ziebach County, South Dakota(6,10)",*,3 or fewer,"Ziebach County, South Dakota",*,*,**,2803,46,137,NA,NA
TN,"Anderson County, Tennessee",13309,5830,7479,47001,42880,43167,36528,NA,62000,35797,31601,4647,34889,3459,66490,8106,"Anderson County, Tennessee(6,10)",71.1,75,"Anderson County, Tennessee",64.7,69,stable,75749,47,1,64.7,71.1
TN,"Bedford County, Tennessee",7727,3542,4185,47003,41984,44287,29068,21497,NA,26859,18606,3862,20181,2944,38787,6806,"Bedford County, Tennessee(6,10)",69.4,35,"Bedford County, Tennessee",56.4,28,stable,47183,47,3,56.4,69.4
TN,"Benton County, Tennessee",3667,1733,1934,47005,33240,33673,27969,NA,NA,40556,6716,1206,6888,1290,13604,2496,"Benton County, Tennessee(6,10)",104.7,26,"Benton County, Tennessee",89,22,stable,16129,47,5,89,104.7
TN,"Bledsoe County, Tennessee",2697,1234,1463,47007,37013,37327,NA,NA,NA,51389,5313,1192,5129,829,10442,2021,"Bledsoe County, Tennessee(6,10)",85.2,15,"Bledsoe County, Tennessee",57.3,10,falling,14502,47,7,57.3,85.2
TN,"Blount County, Tennessee",17305,7389,9916,47009,48286,49144,27961,45078,43359,40141,52291,7725,57700,6300,109991,14025,"Blount County, Tennessee(6,10)",79,130,"Blount County, Tennessee",54.2,89,stable,127253,47,9,54.2,79
TN,"Bradley County, Tennessee",19357,8597,10760,47011,42114,42756,30905,NA,61412,27274,41416,7723,45811,6183,87227,13906,"Bradley County, Tennessee(6,10)",81,97,"Bradley County, Tennessee",56.7,67,falling,104091,47,11,56.7,81
TN,"Campbell County, Tennessee",9203,4004,5199,47013,32028,32177,52276,NA,NA,46190,16363,2910,18002,2375,34365,5285,"Campbell County, Tennessee(6,10)",105.9,60,"Campbell County, Tennessee",86.8,49,stable,39752,47,13,86.8,105.9
TN,"Cannon County, Tennessee",2500,1154,1346,47015,41533,42016,37625,NA,NA,24500,5791,915,6198,715,11989,1630,"Cannon County, Tennessee(6,10)",59.7,11,"Cannon County, Tennessee",58.8,10,stable,13840,47,15,58.8,59.7
TN,"Carroll County, Tennessee",5713,2656,3057,47017,35508,37429,21433,40625,NA,NA,11861,1745,12746,1520,24607,3265,"Carroll County, Tennessee(6,10)",80,32,"Carroll County, Tennessee",61,25,stable,27910,47,17,61,80
TN,"Carter County, Tennessee",13021,6094,6927,47019,33213,33347,19730,NA,40862,21346,22671,4536,24963,3704,47634,8240,"Carter County, Tennessee(6,10)",78.3,63,"Carter County, Tennessee",67.2,54,stable,56486,47,19,67.2,78.3
TN,"Cheatham County, Tennessee",5396,2410,2986,47021,51857,52743,35481,58750,93942,29750,16596,2798,17778,1931,34374,4729,"Cheatham County, Tennessee(6,10)",92.3,38,"Cheatham County, Tennessee",80.6,32,stable,39741,47,21,80.6,92.3
TN,"Chester County, Tennessee",3516,1579,1937,47023,40167,42250,20433,NA,NA,NA,6992,1252,7753,1251,14745,2503,"Chester County, Tennessee(6,10)",76.7,16,"Chester County, Tennessee",48.5,10,stable,17471,47,23,48.5,76.7
TN,"Claiborne County, Tennessee",6658,2951,3707,47025,34899,35281,18750,NA,NA,46500,13480,1832,14369,1537,27849,3369,"Claiborne County, Tennessee(6,10)",107.7,47,"Claiborne County, Tennessee",84.2,36,stable,31709,47,25,84.2,107.7
TN,"Clay County, Tennessee",1801,820,981,47027,28804,28832,NA,NA,NA,35982,3289,504,3422,472,6711,976,"Clay County, Tennessee(6,10)",76.1,9,"Clay County, Tennessee",68.8,9,stable,7771,47,27,68.8,76.1
TN,"Cocke County, Tennessee",9111,4022,5089,47029,31187,31702,25234,NA,NA,NA,14340,2761,15175,2755,29515,5516,"Cocke County, Tennessee(6,10)",96.9,50,"Cocke County, Tennessee",84.1,42,stable,35162,47,29,84.1,96.9
TN,"Coffee County, Tennessee",9818,4470,5348,47031,41590,42197,33108,NA,32955,28917,21912,3746,23965,3245,45877,6991,"Coffee County, Tennessee(6,10)",84.4,57,"Coffee County, Tennessee",62.8,43,stable,54277,47,31,62.8,84.4
TN,"Crockett County, Tennessee",2838,1340,1498,47033,35464,37083,29693,NA,NA,23510,5490,1360,6572,965,12062,2325,"Crockett County, Tennessee(6,10)",64.6,12,"Crockett County, Tennessee",58.2,11,stable,14601,47,33,58.2,64.6
TN,"Cumberland County, Tennessee",9300,4080,5220,47035,38576,38580,145994,49345,114135,34327,23269,4419,25675,3444,48944,7863,"Cumberland County, Tennessee(6,10)",79.8,80,"Cumberland County, Tennessee",62.7,65,stable,58229,47,35,62.7,79.8
TN,"Davidson County, Tennessee",116031,52503,63528,47037,48368,55498,34777,61156,59669,36097,257116,55169,294365,43931,551481,99100,"Davidson County, Tennessee(6,10)",72,424,"Davidson County, Tennessee",57.1,331,falling,678889,47,37,57.1,72
TN,"Decatur County, Tennessee",2470,1098,1372,47039,37263,38495,23750,NA,42500,18243,4817,783,5231,628,10048,1411,"Decatur County, Tennessee(6,10)",87.4,16,"Decatur County, Tennessee",76.1,14,stable,11660,47,39,76.1,87.4
TN,"DeKalb County, Tennessee",3887,1562,2325,47041,38319,38146,43162,NA,186141,30918,7851,1534,8119,1287,15970,2821,"DeKalb County, Tennessee(6,10)",91.3,22,"DeKalb County, Tennessee",71.9,17,stable,19182,47,41,71.9,91.3
TN,"Dickson County, Tennessee",8116,3460,4656,47043,44680,45109,27356,NA,NA,35053,21205,3245,22550,2955,43755,6200,"Dickson County, Tennessee(6,10)",87.9,50,"Dickson County, Tennessee",67.1,38,falling,51487,47,43,67.1,87.9
TN,"Dyer County, Tennessee",6646,2680,3966,47045,42468,44143,35927,NA,26198,47611,16136,1960,17505,1914,33641,3874,"Dyer County, Tennessee(6,10)",77.9,37,"Dyer County, Tennessee",65.4,30,stable,37893,47,45,65.4,77.9
TN,"Fayette County, Tennessee",5351,2427,2924,47047,54890,63996,31071,NA,76375,37120,16771,2081,17849,1678,34620,3759,"Fayette County, Tennessee(6,10)",58.7,31,"Fayette County, Tennessee",49.4,25,stable,39165,47,47,49.4,58.7
TN,"Fentress County, Tennessee",4577,2281,2296,47049,30259,30228,NA,NA,NA,NA,7050,1592,7986,1068,15036,2660,"Fentress County, Tennessee(6,10)",92.7,24,"Fentress County, Tennessee",83,21,stable,17917,47,49,83,92.7
TN,"Franklin County, Tennessee",6669,2889,3780,47051,42773,44659,29590,47105,NA,35267,17691,2152,18771,2174,36462,4326,"Franklin County, Tennessee(6,10)",70.6,41,"Franklin County, Tennessee",54.4,31,stable,41449,47,51,54.4,70.6
TN,"Gibson County, Tennessee",9080,3806,5274,47053,38457,42263,26925,50000,NA,24688,19759,3175,22788,2799,42547,5974,"Gibson County, Tennessee(6,10)",80.5,52,"Gibson County, Tennessee",62.1,40,stable,49399,47,53,62.1,80.5
TN,"Giles County, Tennessee",4627,2011,2616,47055,41093,42674,23881,NA,NA,27237,11866,2083,13097,1514,24963,3597,"Giles County, Tennessee(6,10)",82.1,33,"Giles County, Tennessee",59.9,24,stable,28946,47,55,59.9,82.1
TN,"Grainger County, Tennessee",4647,2091,2556,47057,35391,35695,NA,NA,NA,NA,9876,1399,10088,1227,19964,2626,"Grainger County, Tennessee(6,10)",82.2,26,"Grainger County, Tennessee",73,23,stable,22846,47,57,73,82.2
TN,"Greene County, Tennessee",13647,6146,7501,47059,35196,35485,30662,NA,35733,21065,27714,5087,30385,4211,58099,9298,"Greene County, Tennessee(6,10)",96.4,94,"Greene County, Tennessee",72.2,70,stable,68580,47,59,72.2,96.4
TN,"Grundy County, Tennessee",3797,1683,2114,47061,27373,28244,NA,NA,NA,NA,5078,1516,5653,1091,10731,2607,"Grundy County, Tennessee(6,10)",96.1,19,"Grundy County, Tennessee",81.9,16,stable,13441,47,61,81.9,96.1
TN,"Hamblen County, Tennessee",13193,6285,6908,47063,37617,39145,23917,NA,NA,19621,24472,5810,27420,4556,51892,10366,"Hamblen County, Tennessee(6,10)",77.9,64,"Hamblen County, Tennessee",68.7,55,stable,63402,47,63,68.7,77.9
TN,"Hamilton County, Tennessee",54036,23604,30432,47065,48248,54164,28474,NA,71719,35496,143730,21800,161207,17627,304937,39427,"Hamilton County, Tennessee(6,10)",68.4,286,"Hamilton County, Tennessee",49.6,206,falling,354098,47,65,49.6,68.4
TN,"Hancock County, Tennessee",1793,706,1087,47067,26898,27217,NA,19338,NA,NA,2707,442,2959,371,5666,813,"Hancock County, Tennessee(6,10)",83.1,9,"Hancock County, Tennessee",67.7,7,stable,6572,47,67,67.7,83.1
TN,"Hardeman County, Tennessee",5636,2479,3157,47069,31801,37567,25135,NA,NA,NA,9478,1499,10360,1465,19838,2964,"Hardeman County, Tennessee(6,10)",94.2,31,"Hardeman County, Tennessee",64.3,21,stable,25707,47,69,64.3,94.2
TN,"Hardin County, Tennessee",5920,2494,3426,47071,35290,36024,13844,NA,NA,22006,10421,2093,11258,1736,21679,3829,"Hardin County, Tennessee(6,10)",85.9,33,"Hardin County, Tennessee",63.6,24,stable,25756,47,71,63.6,85.9
TN,"Hawkins County, Tennessee",10661,4410,6251,47073,36927,36938,49313,NA,NA,NA,23655,3800,26009,2563,49664,6363,"Hawkins County, Tennessee(6,10)",102.7,79,"Hawkins County, Tennessee",74.3,57,stable,56471,47,73,74.3,102.7
TN,"Haywood County, Tennessee",4107,1758,2349,47075,34182,43339,23445,NA,NA,50595,6982,1432,8640,961,15622,2393,"Haywood County, Tennessee(6,10)",80.4,18,"Haywood County, Tennessee",57.3,13,stable,18023,47,75,57.3,80.4
TN,"Henderson County, Tennessee",5925,2512,3413,47077,38745,40835,25357,NA,NA,21225,11764,1556,12878,1541,24642,3097,"Henderson County, Tennessee(6,10)",93.4,32,"Henderson County, Tennessee",67.9,23,stable,28015,47,77,67.9,93.4
TN,"Henry County, Tennessee",5862,2421,3441,47079,38234,39801,25625,2499,NA,22147,13056,2240,14504,1927,27560,4167,"Henry County, Tennessee(6,10)",88.4,45,"Henry County, Tennessee",76.7,38,stable,32147,47,79,76.7,88.4
TN,"Hickman County, Tennessee",4738,2218,2520,47081,36334,36343,NA,NA,NA,NA,9243,2136,9564,1870,18807,4006,"Hickman County, Tennessee(6,10)",91.5,27,"Hickman County, Tennessee",73.2,21,stable,24363,47,81,73.2,91.5
TN,"Houston County, Tennessee",1860,949,911,47083,39401,40548,NA,NA,NA,NA,3525,482,3603,487,7128,969,"Houston County, Tennessee(6,10)",96.8,11,"Houston County, Tennessee",80.8,10,stable,8149,47,83,80.8,96.8
TN,"Humphreys County, Tennessee",2856,1312,1544,47085,41949,42328,26463,NA,NA,38333,7632,1281,8283,831,15915,2112,"Humphreys County, Tennessee(6,10)",99.2,26,"Humphreys County, Tennessee",76.4,20,stable,18135,47,85,76.4,99.2
TN,"Jackson County, Tennessee",3034,1443,1591,47087,31534,31826,NA,NA,NA,NA,4755,970,4997,596,9752,1566,"Jackson County, Tennessee(6,10)",102.8,18,"Jackson County, Tennessee",79.9,14,stable,11509,47,87,79.9,102.8
TN,"Jefferson County, Tennessee",8343,3626,4717,47089,42417,43016,32691,NA,NA,32750,22099,3314,23371,2941,45470,6255,"Jefferson County, Tennessee(6,10)",68.9,49,"Jefferson County, Tennessee",51.1,36,falling,53240,47,89,51.1,68.9
TN,"Johnson County, Tennessee",4123,1916,2207,47091,30763,30668,68194,NA,NA,21210,6761,1094,7420,917,14181,2011,"Johnson County, Tennessee(6,10)",88,23,"Johnson County, Tennessee",64.8,17,stable,17830,47,91,64.8,88
TN,"Knox County, Tennessee",69061,31168,37893,47093,48701,51862,26967,40850,64648,32710,188715,25474,205163,21468,393878,46942,"Knox County, Tennessee(6,10)",73.8,357,"Knox County, Tennessee",55.9,268,falling,451324,47,93,55.9,73.8
TN,"Lake County, Tennessee",1319,538,781,47095,30086,34148,20438,NA,NA,21513,1964,378,2389,250,4353,628,"Lake County, Tennessee(6,10)",96.8,9,"Lake County, Tennessee",88.9,8,stable,7576,47,95,88.9,96.8
TN,"Lauderdale County, Tennessee",6532,2877,3655,47097,30281,36438,21414,NA,NA,NA,9660,1851,11096,1950,20756,3801,"Lauderdale County, Tennessee(6,10)",92.9,28,"Lauderdale County, Tennessee",78.7,23,stable,26936,47,97,78.7,92.9
TN,"Lawrence County, Tennessee",8443,3608,4835,47099,37814,38281,21068,11786,NA,49318,16920,3586,17705,3572,34625,7158,"Lawrence County, Tennessee(6,10)",78.2,43,"Lawrence County, Tennessee",68.3,37,stable,42564,47,99,68.3,78.2
TN,"Lewis County, Tennessee",2292,1189,1103,47101,36621,36937,28750,NA,NA,NA,5069,822,4928,891,9997,1713,"Lewis County, Tennessee(6,10)",116.1,19,"Lewis County, Tennessee",81.6,13,stable,11854,47,101,81.6,116.1
TN,"Lincoln County, Tennessee",5517,2540,2977,47103,40389,42135,29464,33333,NA,24519,14055,2213,15084,1824,29139,4037,"Lincoln County, Tennessee(6,10)",64.3,30,"Lincoln County, Tennessee",55.4,25,falling,33743,47,103,55.4,64.3
TN,"Loudon County, Tennessee",7185,3503,3682,47105,51107,50898,38438,NA,202750,31908,21340,2980,22655,2853,43995,5833,"Loudon County, Tennessee(6,10)",69.2,58,"Loudon County, Tennessee",52.7,42,falling,51130,47,105,52.7,69.2
TN,"McMinn County, Tennessee",10220,4598,5622,47107,38535,38736,25694,35750,NA,19670,21366,3828,23727,2762,45093,6590,"McMinn County, Tennessee(6,10)",81.4,59,"McMinn County, Tennessee",68.2,48,stable,52639,47,107,68.2,81.4
TN,"McNairy County, Tennessee",5319,2199,3120,47109,32557,33550,19276,33750,NA,21737,10633,1884,11543,1691,22176,3575,"McNairy County, Tennessee(6,10)",89.5,33,"McNairy County, Tennessee",77.8,28,stable,26066,47,109,77.8,89.5
TN,"Macon County, Tennessee",4218,1836,2382,47111,33509,34481,NA,NA,NA,NA,9374,1653,10107,1307,19481,2960,"Macon County, Tennessee(6,10)",100.4,27,"Macon County, Tennessee",77.5,21,stable,23177,47,111,77.5,100.4
TN,"Madison County, Tennessee",18521,7912,10609,47113,42544,53525,29804,NA,54583,22488,39539,6281,45874,5340,85413,11621,"Madison County, Tennessee(6,10)",70.7,78,"Madison County, Tennessee",52.1,57,falling,97610,47,113,52.1,70.7
TN,"Marion County, Tennessee",5350,2191,3159,47115,41348,42573,30769,NA,85000,NA,11793,1866,12648,1684,24441,3550,"Marion County, Tennessee(6,10)",102.9,40,"Marion County, Tennessee",69.9,27,stable,28487,47,115,69.9,102.9
TN,"Marshall County, Tennessee",4986,2160,2826,47117,42661,43387,27470,NA,NA,32500,12891,2314,13708,1923,26599,4237,"Marshall County, Tennessee(6,10)",91.6,33,"Marshall County, Tennessee",71.9,26,stable,31552,47,117,71.9,91.6
TN,"Maury County, Tennessee",12667,5701,6966,47119,47692,51004,28893,25795,63750,31288,34469,5451,38701,4290,73170,9741,"Maury County, Tennessee(6,10)",73.5,69,"Maury County, Tennessee",61,57,falling,87757,47,119,61,73.5
TN,"Meigs County, Tennessee",2377,906,1471,47121,34424,34311,NA,NA,NA,NA,4855,816,5065,839,9920,1655,"Meigs County, Tennessee(6,10)",83.7,15,"Meigs County, Tennessee",74,12,stable,11830,47,121,74,83.7
TN,"Monroe County, Tennessee",8627,4032,4595,47123,35291,36519,20446,NA,NA,38315,19103,3290,19523,2866,38626,6156,"Monroe County, Tennessee(6,10)",98.6,60,"Monroe County, Tennessee",73.4,45,stable,45771,47,123,73.4,98.6
TN,"Montgomery County, Tennessee",28750,12557,16193,47125,50344,52365,41116,44857,47481,50748,70256,10425,82598,9307,152854,19732,"Montgomery County, Tennessee(6,10)",84.3,106,"Montgomery County, Tennessee",61.2,75,falling,193479,47,125,61.2,84.3
TN,"Moore County, Tennessee",668,268,400,47127,49427,49966,NA,NA,NA,NA,2754,284,2852,367,5606,651,"Moore County, Tennessee(6,10)",63.5,6,"Moore County, Tennessee",35.3,3,**,6322,47,127,35.3,63.5
TN,"Morgan County, Tennessee",4185,2019,2166,47129,39049,39058,NA,NA,NA,NA,7940,1055,8613,955,16553,2010,"Morgan County, Tennessee(6,10)",94.3,26,"Morgan County, Tennessee",71.7,19,falling,21498,47,129,71.7,94.3
TN,"Obion County, Tennessee",6309,2881,3428,47131,40281,42215,21946,NA,NA,23173,12513,2215,14041,1941,26554,4156,"Obion County, Tennessee(6,10)",72.6,31,"Obion County, Tennessee",71.5,30,stable,30639,47,131,71.5,72.6
TN,"Overton County, Tennessee",4668,2273,2395,47133,35287,35258,2499,NA,NA,16333,9276,1406,9830,1293,19106,2699,"Overton County, Tennessee(6,10)",98.2,32,"Overton County, Tennessee",84.8,26,stable,22129,47,133,84.8,98.2
TN,"Perry County, Tennessee",1995,865,1130,47135,31425,32151,NA,NA,NA,NA,3169,731,3164,667,6333,1398,"Perry County, Tennessee(6,10)",93.8,11,"Perry County, Tennessee",77.3,9,stable,7929,47,135,77.3,93.8
TN,"Pickett County, Tennessee",808,315,493,47137,36773,37338,NA,NA,NA,NA,2078,391,2231,305,4309,696,"Pickett County, Tennessee(6,10)",94.8,8,"Pickett County, Tennessee",65.2,6,stable,5146,47,137,65.2,94.8
TN,"Polk County, Tennessee",3094,1481,1613,47139,38925,39296,NA,16477,NA,NA,7102,1098,7282,968,14384,2066,"Polk County, Tennessee(6,10)",116,28,"Polk County, Tennessee",103.3,25,stable,16773,47,139,103.3,116
TN,"Putnam County, Tennessee",17830,8209,9621,47141,35343,35863,17974,9539,NA,37482,29982,5917,32553,4582,62535,10499,"Putnam County, Tennessee(6,10)",71.6,62,"Putnam County, Tennessee",54.9,47,stable,74553,47,141,54.9,71.6
TN,"Rhea County, Tennessee",7664,3510,4154,47143,36146,36085,37337,NA,NA,28063,13770,2097,14544,1610,28314,3707,"Rhea County, Tennessee(6,10)",99,41,"Rhea County, Tennessee",77.5,31,stable,32526,47,143,77.5,99
TN,"Roane County, Tennessee",9620,4479,5141,47145,40854,41451,37143,NA,89722,NA,22459,3278,24188,2686,46647,5964,"Roane County, Tennessee(6,10)",88.6,72,"Roane County, Tennessee",71.1,58,stable,52753,47,145,71.1,88.6
TN,"Robertson County, Tennessee",8005,3441,4564,47147,53151,55246,35804,NA,60363,39321,27866,4735,30884,3162,58750,7897,"Robertson County, Tennessee(6,10)",83.2,59,"Robertson County, Tennessee",65.1,45,stable,68570,47,147,65.1,83.2
TN,"Rutherford County, Tennessee",34475,15822,18653,47149,56219,58289,46315,NA,64022,41350,119135,18793,127230,15032,246365,33825,"Rutherford County, Tennessee(6,10)",68.5,144,"Rutherford County, Tennessee",50.3,102,falling,298612,47,149,50.3,68.5
TN,"Scott County, Tennessee",5903,2663,3240,47151,30246,30455,NA,NA,NA,NA,8916,1704,9606,1510,18522,3214,"Scott County, Tennessee(6,10)",109.2,29,"Scott County, Tennessee",94.9,24,stable,21950,47,151,94.9,109.2
TN,"Sequatchie County, Tennessee",2335,979,1356,47153,45408,46633,NA,55652,NA,NA,6370,702,6438,861,12808,1563,"Sequatchie County, Tennessee(6,10)",96.8,18,"Sequatchie County, Tennessee",86.6,16,rising,14811,47,153,86.6,96.8
TN,"Sevier County, Tennessee",14128,6136,7992,47155,42258,42542,41320,NA,41449,32952,35661,9701,38995,8383,74656,18084,"Sevier County, Tennessee(6,10)",83.5,99,"Sevier County, Tennessee",61.8,72,stable,95946,47,155,61.8,83.5
TN,"Shelby County, Tennessee",196471,87291,109180,47157,46224,66517,32926,31892,80080,35102,362755,75492,425842,61338,788597,136830,"Shelby County, Tennessee(6,10)",67.3,587,"Shelby County, Tennessee",53.2,457,falling,938069,47,157,53.2,67.3
TN,"Smith County, Tennessee",3066,1307,1759,47159,43914,44382,33077,NA,NA,50125,8337,1010,8590,954,16927,1964,"Smith County, Tennessee(6,10)",92.7,21,"Smith County, Tennessee",81.4,18,stable,19295,47,159,81.4,92.7
TN,"Stewart County, Tennessee",2560,1236,1324,47161,42023,42763,32150,NA,12143,16591,5719,822,5829,726,11548,1548,"Stewart County, Tennessee(6,10)",90.8,17,"Stewart County, Tennessee",69.5,12,stable,13259,47,161,69.5,90.8
TN,"Sullivan County, Tennessee",26924,12365,14559,47163,40346,40811,30756,40862,53611,23659,64972,9918,71960,8207,136932,18125,"Sullivan County, Tennessee(6,10)",75.7,174,"Sullivan County, Tennessee",59.7,138,stable,156791,47,163,59.7,75.7
TN,"Sumner County, Tennessee",15644,6676,8968,47165,57382,58301,46756,49773,73810,37443,72373,9532,78051,8131,150424,17663,"Sumner County, Tennessee(6,10)",65.9,121,"Sumner County, Tennessee",51.8,92,stable,175989,47,165,51.8,65.9
TN,"Tipton County, Tennessee",8292,3516,4776,47167,53669,58999,30694,131776,37340,63627,25881,4018,27879,2992,53760,7010,"Tipton County, Tennessee(6,10)",94.6,60,"Tipton County, Tennessee",74.6,45,stable,61870,47,167,74.6,94.6
TN,"Trousdale County, Tennessee",1345,614,731,47169,41029,46500,27917,NA,NA,NA,3132,702,3604,304,6736,1006,"Trousdale County, Tennessee(6,10)",101.4,9,"Trousdale County, Tennessee",59.6,6,stable,8042,47,169,59.6,101.4
TN,"Unicoi County, Tennessee",3974,1790,2184,47171,33210,33316,NA,NA,NA,26202,7447,1353,7908,1026,15355,2379,"Unicoi County, Tennessee(6,10)",89.3,25,"Unicoi County, Tennessee",70.8,20,stable,17860,47,171,70.8,89.3
TN,"Union County, Tennessee",4036,1575,2461,47173,37351,37393,NA,NA,NA,36026,8076,1337,8249,1273,16325,2610,"Union County, Tennessee(6,10)",100.7,24,"Union County, Tennessee",76.2,18,stable,19119,47,173,76.2,100.7
TN,"Van Buren County, Tennessee",988,523,465,47175,40439,40659,NA,NA,NA,66406,2385,342,2324,444,4709,786,"Van Buren County, Tennessee(6,10)",55.8,4,"Van Buren County, Tennessee",53,4,stable,5677,47,175,53,55.8
TN,"Warren County, Tennessee",8329,3964,4365,47177,35376,36395,25577,7750,2499,26789,16252,3256,17765,2210,34017,5466,"Warren County, Tennessee(6,10)",84.7,42,"Warren County, Tennessee",64.4,33,stable,40435,47,177,64.4,84.7
TN,"Washington County, Tennessee",21842,9588,12254,47179,42817,43305,29939,40737,68229,36268,52464,7566,56336,7167,108800,14733,"Washington County, Tennessee(6,10)",71.6,110,"Washington County, Tennessee",55.3,84,stable,126302,47,179,55.3,71.6
TN,"Wayne County, Tennessee",3211,1619,1592,47181,30701,30931,16167,NA,25000,21964,6169,1124,6540,956,12709,2080,"Wayne County, Tennessee(6,10)",79.1,18,"Wayne County, Tennessee",72.6,16,stable,16748,47,181,72.6,79.1
TN,"Weakley County, Tennessee",6075,2810,3265,47183,37037,38636,20331,NA,NA,41548,14459,2122,15906,1468,30365,3590,"Weakley County, Tennessee(6,10)",72.4,31,"Weakley County, Tennessee",61.2,26,stable,33960,47,183,61.2,72.4
TN,"White County, Tennessee",5011,2341,2670,47185,34901,35297,27574,NA,NA,NA,10891,1717,11526,1711,22417,3428,"White County, Tennessee(6,10)",89.7,33,"White County, Tennessee",65.7,23,stable,26521,47,185,65.7,89.7
TN,"Williamson County, Tennessee",10054,4225,5829,47187,96565,97939,66719,230583,105558,58581,91344,5695,96717,5137,188061,10832,"Williamson County, Tennessee(6,10)",46.6,77,"Williamson County, Tennessee",36.5,60,falling,211672,47,187,36.5,46.6
TN,"Wilson County, Tennessee",12132,4886,7246,47189,61070,62769,35035,30893,78571,39795,52625,6781,56770,5281,109395,12062,"Wilson County, Tennessee(6,10)",76.5,98,"Wilson County, Tennessee",55.3,68,stable,128911,47,189,55.3,76.5
TX,"Anderson County, Texas",8274,3779,4495,48001,41327,45789,23056,NA,61552,32139,18394,4247,18148,4112,36542,8359,"Anderson County, Texas(6,10)",78.1,49,"Anderson County, Texas",70.1,44,falling,57580,48,1,70.1,78.1
TX,"Andrews County, Texas",2032,832,1200,48003,70423,71077,36689,NA,NA,68617,7005,1505,6326,1847,13331,3352,"Andrews County, Texas(6,10)",64.3,9,"Andrews County, Texas",47.6,7,stable,18105,48,3,47.6,64.3
TX,"Angelina County, Texas",16497,7061,9436,48005,44223,48264,28914,19115,45545,38249,32551,8647,36126,8248,68677,16895,"Angelina County, Texas(6,10)",76.4,74,"Angelina County, Texas",48.3,47,falling,88255,48,5,48.3,76.4
TX,"Aransas County, Texas",4509,2097,2412,48007,41690,41315,NA,NA,NA,41480,9334,2419,9949,2164,19283,4583,"Aransas County, Texas(6,10)",78.1,33,"Aransas County, Texas",56.6,24,falling,25350,48,7,56.6,78.1
TX,"Archer County, Texas",862,352,510,48009,60275,60714,NA,NA,NA,33750,3703,631,3866,508,7569,1139,"Archer County, Texas(6,10)",61.5,8,"Archer County, Texas",45.9,5,falling,8715,48,9,45.9,61.5
TX,"Armstrong County, Texas",130,49,81,48011,59737,58684,NA,NA,NA,157614,835,119,837,87,1672,206,"Armstrong County, Texas(6,10)",*,3 or fewer,"Armstrong County, Texas",*,*,**,1947,48,11,NA,NA
TX,"Atascosa County, Texas",7619,3141,4478,48013,52192,52129,47429,50313,NA,45858,18670,4520,18867,4536,37537,9056,"Atascosa County, Texas(6,10)",42.4,21,"Atascosa County, Texas",31.9,16,falling,48435,48,13,31.9,42.4
TX,"Austin County, Texas",3289,1377,1912,48015,53687,55871,42550,NA,NA,43864,11830,2424,11973,2414,23803,4838,"Austin County, Texas(6,10)",48,18,"Austin County, Texas",41,15,stable,29563,48,15,41,48
TX,"Bailey County, Texas",1319,500,819,48017,37397,40208,NA,NA,NA,32520,2577,1020,2319,1080,4896,2100,"Bailey County, Texas(6,10)",*,3 or fewer,"Bailey County, Texas",*,*,**,7210,48,17,NA,NA
TX,"Bandera County, Texas",2662,1322,1340,48019,49863,49651,NA,NA,NA,63478,8362,1913,8601,1726,16963,3639,"Bandera County, Texas(6,10)",58.8,20,"Bandera County, Texas",42.9,15,falling,21269,48,19,42.9,58.8
TX,"Bastrop County, Texas",10664,4867,5797,48021,54821,57274,47545,34185,79063,41443,30120,7315,30045,7386,60165,14701,"Bastrop County, Texas(6,10)",69.2,54,"Bastrop County, Texas",56.6,43,stable,80527,48,21,56.6,69.2
TX,"Baylor County, Texas",423,143,280,48023,36373,39375,NA,NA,NA,16591,1359,397,1524,275,2883,672,"Baylor County, Texas(6,10)",80.4,5,"Baylor County, Texas",57.6,4,**,3618,48,23,57.6,80.4
TX,"Bee County, Texas",5274,2344,2930,48025,42302,43706,33924,NA,NA,36743,9837,2439,9597,3215,19434,5654,"Bee County, Texas(6,10)",50.9,15,"Bee County, Texas",33.2,9,falling,32874,48,25,33.2,50.9
TX,"Bell County, Texas",48543,21926,26617,48027,50550,53878,44646,60205,47929,43438,122102,21650,138608,21336,260710,42986,"Bell County, Texas(6,10)",81.5,200,"Bell County, Texas",54.1,130,falling,334941,48,27,54.1,81.5
TX,"Bexar County, Texas",312088,140680,171408,48029,51150,52931,42450,42873,63595,42721,708529,166188,762263,156662,1470792,322850,"Bexar County, Texas(6,10)",45.1,702,"Bexar County, Texas",34.5,528,falling,1897753,48,29,34.5,45.1
TX,"Blanco County, Texas",954,451,503,48031,55504,56639,NA,NA,NA,43767,4327,1037,4158,1089,8485,2126,"Blanco County, Texas(6,10)",46.3,8,"Blanco County, Texas",28.2,5,falling,11004,48,31,28.2,46.3
TX,"Borden County, Texas",10,5,5,48033,73750,72813,NA,NA,NA,58194,352,10,314,29,666,39,"Borden County, Texas(6,10)",*,3 or fewer,"Borden County, Texas",*,*,**,648,48,33,NA,NA
TX,"Bosque County, Texas",2549,1144,1405,48035,44674,45320,NA,80341,20208,33179,6862,1821,7135,1805,13997,3626,"Bosque County, Texas(6,10)",58.4,17,"Bosque County, Texas",59.2,18,stable,17891,48,35,59.2,58.4
TX,"Bowie County, Texas",16693,7537,9156,48037,42670,47666,26246,85455,44141,27699,34412,7917,38080,7433,72492,15350,"Bowie County, Texas(6,10)",80.2,88,"Bowie County, Texas",58.7,63,falling,93389,48,37,58.7,80.2
TX,"Brazoria County, Texas",35762,16016,19746,48039,69749,69781,62534,73750,111273,56698,132481,26179,136174,26559,268655,52738,"Brazoria County, Texas(6,10)",63,175,"Brazoria County, Texas",47.6,130,falling,346312,48,39,47.6,63
TX,"Brazos County, Texas",53207,25213,27994,48041,39808,44680,27751,64219,31278,34924,85232,16282,85931,13975,171163,30257,"Brazos County, Texas(6,10)",49,62,"Brazos County, Texas",37.2,47,falling,215037,48,41,37.2,49
TX,"Brewster County, Texas",1238,508,730,48043,38395,38462,NA,NA,NA,34568,3454,921,3970,808,7424,1729,"Brewster County, Texas(6,10)",36.4,4,"Brewster County, Texas",33.4,4,**,9145,48,43,33.4,36.4
TX,"Briscoe County, Texas",307,156,151,48045,38603,39559,13125,NA,NA,25938,659,212,618,181,1277,393,"Briscoe County, Texas(6,10)",*,3 or fewer,"Briscoe County, Texas",*,*,**,1505,48,45,NA,NA
TX,"Brooks County, Texas",2726,1476,1250,48047,22741,22103,NA,NA,NA,22854,2335,1150,2526,887,4861,2037,"Brooks County, Texas(6,10)",*,3 or fewer,"Brooks County, Texas",*,*,**,7230,48,47,NA,NA
TX,"Brown County, Texas",6581,2868,3713,48049,41962,42481,31548,18319,NA,36950,14557,3542,16086,2617,30643,6159,"Brown County, Texas(6,10)",65.2,34,"Brown County, Texas",52.3,28,falling,37896,48,49,52.3,65.2
TX,"Burleson County, Texas",2761,1259,1502,48051,51821,55259,30909,NA,NA,46192,7037,1491,6762,1830,13799,3321,"Burleson County, Texas(6,10)",73.1,18,"Burleson County, Texas",53.6,13,stable,17460,48,51,53.6,73.1
TX,"Burnet County, Texas",6989,3317,3672,48053,49732,50281,68452,51875,NA,33512,17966,3763,18362,3739,36328,7502,"Burnet County, Texas(6,10)",65.3,43,"Burnet County, Texas",45.7,30,falling,45463,48,53,45.7,65.3
TX,"Caldwell County, Texas",7169,3540,3629,48055,47233,49238,29816,46000,NA,41705,13968,4891,14535,4039,28503,8930,"Caldwell County, Texas(6,10)",65.1,26,"Caldwell County, Texas",45.9,18,falling,40522,48,55,45.9,65.1
TX,"Calhoun County, Texas",4136,1987,2149,48057,51078,50803,45407,NA,69318,40458,8824,1912,8892,1844,17716,3756,"Calhoun County, Texas(6,10)",70,18,"Calhoun County, Texas",46.3,12,falling,21895,48,57,46.3,70
TX,"Callahan County, Texas",2548,1107,1441,48059,40981,41009,24500,NA,NA,36944,4976,1607,5360,1508,10336,3115,"Callahan County, Texas(6,10)",80.4,16,"Callahan County, Texas",69.4,14,stable,13557,48,59,69.4,80.4
TX,"Cameron County, Texas",139768,63753,76015,48061,33266,33004,36583,33558,99196,30795,137295,62556,146719,68645,284014,131201,"Cameron County, Texas(6,10)",38.4,143,"Cameron County, Texas",24,89,falling,422156,48,61,24,38.4
TX,"Camp County, Texas",2454,1046,1408,48063,37851,40938,21661,NA,NA,35677,4688,1389,4971,1400,9659,2789,"Camp County, Texas(6,10)",74.8,12,"Camp County, Texas",53.4,9,falling,12682,48,63,53.4,74.8
TX,"Carson County, Texas",435,202,233,48065,66023,66818,NA,53611,NA,79444,2499,411,2655,455,5154,866,"Carson County, Texas(6,10)",44.5,4,"Carson County, Texas",45,4,stable,5969,48,65,45,44.5
TX,"Cass County, Texas",5915,2548,3367,48067,37352,41114,23500,NA,41014,NA,11536,2986,12405,2993,23941,5979,"Cass County, Texas(6,10)",68.9,32,"Cass County, Texas",58.8,27,stable,30313,48,67,58.8,68.9
TX,"Castro County, Texas",1339,672,667,48069,39459,40000,NA,NA,NA,30800,2591,1412,2678,1177,5269,2589,"Castro County, Texas(6,10)",50.7,5,"Castro County, Texas",35.5,3,**,7656,48,69,35.5,50.7
TX,"Chambers County, Texas",3921,1677,2244,48071,70544,75877,44962,9750,133387,48743,15184,3360,15082,3420,30266,6780,"Chambers County, Texas(6,10)",68.3,21,"Chambers County, Texas",56.9,17,stable,38863,48,71,56.9,68.3
TX,"Cherokee County, Texas",10688,4875,5813,48073,39595,42449,19321,37083,35114,34673,19081,5260,19740,4874,38821,10134,"Cherokee County, Texas(6,10)",83.3,51,"Cherokee County, Texas",60.3,37,falling,51542,48,73,60.3,83.3
TX,"Childress County, Texas",1177,573,604,48075,36633,38333,NA,NA,NA,NA,2421,470,2582,350,5003,820,"Childress County, Texas(6,10)",72.5,6,"Childress County, Texas",50.5,4,stable,7088,48,75,50.5,72.5
TX,"Clay County, Texas",1246,620,626,48077,48297,49203,NA,NA,NA,60000,4461,766,4233,943,8694,1709,"Clay County, Texas(6,10)",68.8,11,"Clay County, Texas",55.3,9,stable,10360,48,77,55.3,68.8
TX,"Cochran County, Texas",591,267,324,48079,39113,39808,20938,NA,NA,28942,1002,497,1038,412,2040,909,"Cochran County, Texas(6,10)",*,3 or fewer,"Cochran County, Texas",*,*,**,2953,48,79,NA,NA
TX,"Coke County, Texas",361,152,209,48081,42467,42467,NA,NA,NA,30917,1277,310,1282,252,2559,562,"Coke County, Texas(6,10)",52.5,3,"Coke County, Texas",*,*,*,3238,48,81,NA,52.5
TX,"Coleman County, Texas",1924,720,1204,48083,35156,35228,41618,NA,NA,33333,3084,1115,3194,1106,6278,2221,"Coleman County, Texas(6,10)",70.7,10,"Coleman County, Texas",61.8,9,stable,8338,48,83,61.8,70.7
TX,"Collin County, Texas",64824,30107,34717,48085,84735,86517,64806,93355,103313,54558,364117,57505,384036,53416,748153,110921,"Collin County, Texas(6,10)",49.4,286,"Collin County, Texas",36.7,207,falling,914127,48,85,36.7,49.4
TX,"Collingsworth County, Texas",675,229,446,48087,39743,43520,NA,18000,NA,26214,1119,351,1189,337,2308,688,"Collingsworth County, Texas(6,10)",*,3 or fewer,"Collingsworth County, Texas",*,*,**,3044,48,87,NA,NA
TX,"Colorado County, Texas",3081,1430,1651,48089,46618,49512,25884,NA,NA,36524,8211,1852,8609,1745,16820,3597,"Colorado County, Texas(6,10)",65.6,20,"Colorado County, Texas",57.6,18,rising,20870,48,89,57.6,65.6
TX,"Comal County, Texas",10423,4122,6301,48091,65833,66156,71536,114904,71272,54888,49481,9194,51021,8970,100502,18164,"Comal County, Texas(6,10)",58.1,83,"Comal County, Texas",42.7,61,stable,129048,48,91,42.7,58.1
TX,"Comanche County, Texas",3107,1420,1687,48093,37470,38030,NA,NA,NA,32065,4842,1755,5054,1778,9896,3533,"Comanche County, Texas(6,10)",76.4,17,"Comanche County, Texas",61.6,13,stable,13430,48,93,61.6,76.4
TX,"Concho County, Texas",298,81,217,48095,48368,48485,NA,NA,NA,26827,1211,148,1081,245,2292,393,"Concho County, Texas(6,10)",*,3 or fewer,"Concho County, Texas",*,*,**,4081,48,95,NA,NA
TX,"Cooke County, Texas",5292,2322,2970,48097,52406,53402,29886,NA,NA,39560,15879,2963,16252,3158,32131,6121,"Cooke County, Texas(6,10)",62.1,32,"Cooke County, Texas",53.7,27,stable,39229,48,97,53.7,62.1
TX,"Coryell County, Texas",8631,3528,5103,48099,49340,50512,49083,48403,41667,38850,23726,2768,29019,3462,52745,6230,"Coryell County, Texas(6,10)",81.2,41,"Coryell County, Texas",58.1,28,falling,75503,48,99,58.1,81.2
TX,"Cottle County, Texas",340,167,173,48101,34955,37067,30179,NA,NA,30179,582,204,557,167,1139,371,"Cottle County, Texas(6,10)",*,3 or fewer,"Cottle County, Texas",*,*,**,1426,48,101,NA,NA
TX,"Crane County, Texas",606,236,370,48103,58333,54083,NA,NA,NA,57868,1940,387,1840,469,3780,856,"Crane County, Texas(6,10)",*,3 or fewer,"Crane County, Texas",*,*,**,5048,48,103,NA,NA
TX,"Crockett County, Texas",635,239,396,48105,53678,54412,NA,NA,NA,51481,1499,308,1388,424,2887,732,"Crockett County, Texas(6,10)",*,3 or fewer,"Crockett County, Texas",*,*,**,3710,48,105,NA,NA
TX,"Crosby County, Texas",1358,544,814,48107,37434,38628,19464,NA,NA,33102,2246,626,2210,834,4456,1460,"Crosby County, Texas(6,10)",57,5,"Crosby County, Texas",38.2,3,stable,5977,48,107,38.2,57
TX,"Culberson County, Texas",677,307,370,48109,35000,35302,NA,NA,NA,26111,881,231,916,255,1797,486,"Culberson County, Texas(6,10)",*,3 or fewer,"Culberson County, Texas",*,*,**,2236,48,109,NA,NA
TX,"Dallam County, Texas",1183,511,672,48111,41345,41239,82639,61750,63750,33125,2899,819,2415,842,5314,1661,"Dallam County, Texas(6,10)",79.4,4,"Dallam County, Texas",*,*,**,7121,48,111,NA,79.4
TX,"Dallas County, Texas",472926,211723,261203,48113,50270,56527,37476,40843,68847,40562,887696,324950,964891,287195,1852587,612145,"Dallas County, Texas(6,10)",56,1078,"Dallas County, Texas",42.8,802,falling,2553385,48,113,42.8,56
TX,"Dawson County, Texas",1924,729,1195,48115,41095,43706,20511,13490,NA,32052,4527,1246,4383,1466,8910,2712,"Dawson County, Texas(6,10)",59.2,9,"Dawson County, Texas",37.1,6,stable,13520,48,115,37.1,59.2
TX,"Deaf Smith County, Texas",3955,1687,2268,48117,43373,45901,24844,NA,NA,37617,7472,1901,7461,2224,14933,4125,"Deaf Smith County, Texas(6,10)",55.1,10,"Deaf Smith County, Texas",41.7,7,stable,18952,48,117,41.7,55.1
TX,"Delta County, Texas",1177,554,623,48119,42432,44720,10878,NA,NA,NA,2060,509,2158,425,4218,934,"Delta County, Texas(6,10)",58.8,5,"Delta County, Texas",50.8,4,stable,5217,48,119,50.8,58.8
TX,"Denton County, Texas",63220,27578,35642,48121,75050,78489,53611,68480,91790,52184,304587,52747,318578,51497,623165,104244,"Denton County, Texas(6,10)",53.3,245,"Denton County, Texas",37.4,169,falling,780612,48,121,37.4,53.3
TX,"DeWitt County, Texas",2817,1289,1528,48123,49736,59308,28950,NA,NA,33625,7634,1642,7941,1559,15575,3201,"DeWitt County, Texas(6,10)",57.9,17,"DeWitt County, Texas",52.8,15,stable,20797,48,123,52.8,57.9
TX,"Dickens County, Texas",417,192,225,48125,39700,40670,NA,NA,NA,9531,824,199,842,212,1666,411,"Dickens County, Texas(6,10)",*,3 or fewer,"Dickens County, Texas",*,*,**,2206,48,125,NA,NA
TX,"Dimmit County, Texas",2003,721,1282,48127,36825,36998,NA,NA,NA,33056,3776,1372,4082,1357,7858,2729,"Dimmit County, Texas(6,10)",32.2,4,"Dimmit County, Texas",*,*,**,10980,48,127,NA,32.2
TX,"Donley County, Texas",585,247,338,48129,36681,38872,19904,NA,NA,30500,1346,377,1596,221,2942,598,"Donley County, Texas(6,10)",74,5,"Donley County, Texas",56.3,4,stable,3499,48,129,56.3,74
TX,"Duval County, Texas",2617,1093,1524,48131,33939,37661,NA,NA,NA,31831,4007,1549,3919,1571,7926,3120,"Duval County, Texas(6,10)",45.6,7,"Duval County, Texas",33,5,falling,11388,48,131,33,45.6
TX,"Eastland County, Texas",3162,1312,1850,48133,34888,35067,NA,11875,NA,21920,6769,2117,7380,1794,14149,3911,"Eastland County, Texas(6,10)",71,21,"Eastland County, Texas",58.8,16,stable,18171,48,133,58.8,71
TX,"Ector County, Texas",19162,7745,11417,48135,57150,59738,48448,55885,90729,52243,57129,17173,55289,18582,112418,35755,"Ector County, Texas(6,10)",69.9,85,"Ector County, Texas",50.4,61,falling,159436,48,135,50.4,69.9
TX,"Edwards County, Texas",205,105,100,48137,41813,43194,NA,NA,NA,30435,686,156,879,173,1565,329,"Edwards County, Texas(6,10)",*,3 or fewer,"Edwards County, Texas",*,*,**,1894,48,137,NA,NA
TX,"Ellis County, Texas",18755,8310,10445,48139,62465,65791,47199,37083,122917,44609,62565,14337,64983,13907,127548,28244,"Ellis County, Texas(6,10)",64.8,91,"Ellis County, Texas",50.2,68,falling,163632,48,139,50.2,64.8
TX,"El Paso County, Texas",185728,81700,104028,48141,41637,42307,51804,38654,62375,37361,283850,99022,317237,104788,601087,203810,"El Paso County, Texas(6,10)",32.9,231,"El Paso County, Texas",24.3,169,falling,835593,48,141,24.3,32.9
TX,"Erath County, Texas",9340,3732,5608,48143,41416,41383,2499,NA,NA,34521,15099,4392,15903,4153,31002,8545,"Erath County, Texas(6,10)",53.1,21,"Erath County, Texas",34.4,14,falling,41122,48,143,34.4,53.1
TX,"Falls County, Texas",3417,1589,1828,48145,36079,39936,24646,NA,NA,23631,5895,1842,6431,1364,12326,3206,"Falls County, Texas(6,10)",61,14,"Falls County, Texas",43.5,10,stable,17142,48,145,43.5,61
TX,"Fannin County, Texas",5305,2544,2761,48147,44071,46322,18967,35179,NA,35313,12352,2745,13042,2688,25394,5433,"Fannin County, Texas(6,10)",78.7,36,"Fannin County, Texas",58.8,27,stable,33693,48,147,58.8,78.7
TX,"Fayette County, Texas",3021,1282,1739,48149,47808,49597,36714,NA,NA,45453,10407,1766,10148,2107,20555,3873,"Fayette County, Texas(6,10)",54.2,22,"Fayette County, Texas",33.3,14,stable,25110,48,149,33.3,54.2
TX,"Fisher County, Texas",666,252,414,48151,41406,44922,33583,NA,NA,36250,1412,390,1642,390,3054,780,"Fisher County, Texas(6,10)",46.7,3,"Fisher County, Texas",46.9,3,stable,3827,48,151,46.9,46.7
TX,"Floyd County, Texas",1375,613,762,48153,41026,43598,22857,NA,NA,35042,2239,772,2521,597,4760,1369,"Floyd County, Texas(6,10)",61.1,5,"Floyd County, Texas",44.9,4,stable,5901,48,153,44.9,61.1
TX,"Foard County, Texas",114,52,62,48155,36477,37386,20938,NA,NA,39375,496,73,531,64,1027,137,"Foard County, Texas(6,10)",*,3 or fewer,"Foard County, Texas",*,*,**,1220,48,155,NA,NA
TX,"Fort Bend County, Texas",53761,23618,30143,48157,89152,95083,71559,98990,108287,62318,270364,48895,285749,48185,556113,97080,"Fort Bend County, Texas(6,10)",43.1,188,"Fort Bend County, Texas",31.9,132,falling,716087,48,157,31.9,43.1
TX,"Franklin County, Texas",1726,878,848,48159,41537,43449,18148,NA,NA,33750,4374,940,4210,961,8584,1901,"Franklin County, Texas(6,10)",78.4,12,"Franklin County, Texas",51.4,8,stable,10651,48,159,51.4,78.4
TX,"Freestone County, Texas",2683,1178,1505,48161,44301,50553,29286,23214,NA,22014,7124,1715,7321,1907,14445,3622,"Freestone County, Texas(6,10)",60.1,16,"Freestone County, Texas",49,13,stable,19691,48,161,49,60.1
TX,"Frio County, Texas",3321,1607,1714,48163,36404,39200,NA,NA,NA,34116,6192,1524,5279,2060,11471,3584,"Frio County, Texas(6,10)",39.2,6,"Frio County, Texas",31.9,5,stable,18793,48,163,31.9,39.2
TX,"Gaines County, Texas",2177,1018,1159,48165,57635,56968,60804,88523,NA,53015,6378,3133,6053,3244,12431,6377,"Gaines County, Texas(6,10)",46.8,7,"Gaines County, Texas",43.3,6,stable,20051,48,165,43.3,46.8
TX,"Galveston County, Texas",41985,18622,23363,48167,62313,67608,34761,80393,60239,48705,124825,25166,129851,23892,254676,49058,"Galveston County, Texas(6,10)",63.2,192,"Galveston County, Texas",54.5,162,falling,322225,48,167,54.5,63.2
TX,"Garza County, Texas",432,204,228,48169,48508,50625,70592,NA,NA,41250,1545,484,1668,457,3213,941,"Garza County, Texas(6,10)",61.3,4,"Garza County, Texas",*,*,**,6415,48,169,NA,61.3
TX,"Gillespie County, Texas",2791,1403,1388,48171,54859,54232,NA,65488,NA,37083,9971,2226,10717,2091,20688,4317,"Gillespie County, Texas(6,10)",48.8,25,"Gillespie County, Texas",37.5,19,stable,25963,48,171,37.5,48.8
TX,"Glasscock County, Texas",40,20,20,48173,67303,73125,NA,NA,NA,41989,516,139,446,79,962,218,"Glasscock County, Texas(6,10)",*,3 or fewer,"Glasscock County, Texas",*,*,**,1315,48,173,NA,NA
TX,"Goliad County, Texas",1358,685,673,48175,51226,59837,21081,NA,NA,45185,3155,413,3291,434,6446,847,"Goliad County, Texas(6,10)",65.5,7,"Goliad County, Texas",47.9,5,**,7531,48,175,47.9,65.5
TX,"Gonzales County, Texas",4009,1702,2307,48177,42983,48133,16300,NA,NA,39713,7522,2441,7408,2512,14930,4953,"Gonzales County, Texas(6,10)",47.3,12,"Gonzales County, Texas",40.4,10,falling,20573,48,177,40.4,47.3
TX,"Gray County, Texas",2824,1266,1558,48179,43288,44525,38021,29271,44583,37348,8533,2177,8407,2220,16940,4397,"Gray County, Texas(6,10)",90.1,25,"Gray County, Texas",57.2,16,stable,23210,48,179,57.2,90.1
TX,"Grayson County, Texas",19420,8783,10637,48181,47952,50592,23841,42045,47929,40790,47981,11386,51363,10713,99344,22099,"Grayson County, Texas(6,10)",78,120,"Grayson County, Texas",56.5,87,falling,125467,48,181,56.5,78
TX,"Gregg County, Texas",21769,9209,12560,48183,47639,52245,26654,54205,62131,41944,46507,12687,50620,11455,97127,24142,"Gregg County, Texas(6,10)",71.9,97,"Gregg County, Texas",55.6,76,falling,124108,48,183,55.6,71.9
TX,"Grimes County, Texas",4701,2278,2423,48185,46195,51776,20698,25318,NA,48207,9497,2198,9357,2658,18854,4856,"Grimes County, Texas(6,10)",48.2,15,"Grimes County, Texas",43.2,14,falling,27512,48,185,43.2,48.2
TX,"Guadalupe County, Texas",13924,5939,7985,48187,62420,63571,64646,55726,71542,50786,58660,10828,61380,10367,120040,21195,"Guadalupe County, Texas(6,10)",58.6,80,"Guadalupe County, Texas",41.6,56,falling,151249,48,187,41.6,58.6
TX,"Hale County, Texas",7548,3137,4411,48189,43375,43622,25000,30888,43750,38112,12814,3663,13412,3543,26226,7206,"Hale County, Texas(6,10)",60,21,"Hale County, Texas",43.1,15,stable,34360,48,189,43.1,60
TX,"Hall County, Texas",844,417,427,48191,30950,32327,20048,NA,NA,26964,1206,370,1129,440,2335,810,"Hall County, Texas(6,10)",65.4,4,"Hall County, Texas",*,*,**,3138,48,191,NA,65.4
TX,"Hamilton County, Texas",1159,545,614,48193,42432,43381,NA,NA,NA,21938,3075,826,3688,443,6763,1269,"Hamilton County, Texas(6,10)",59.4,9,"Hamilton County, Texas",41.9,7,stable,8159,48,193,41.9,59.4
TX,"Hansford County, Texas",939,455,484,48195,44219,44920,NA,NA,NA,35417,2276,489,2246,478,4522,967,"Hansford County, Texas(6,10)",61.3,4,"Hansford County, Texas",*,*,*,5610,48,195,NA,61.3
TX,"Hardeman County, Texas",585,284,301,48197,37174,39415,13980,NA,NA,32500,1532,391,1712,345,3244,736,"Hardeman County, Texas(6,10)",76.1,4,"Hardeman County, Texas",*,*,*,3840,48,197,NA,76.1
TX,"Hardin County, Texas",6684,2682,4002,48199,52614,55030,32454,27473,46290,55862,22225,4897,22861,4952,45086,9849,"Hardin County, Texas(6,10)",66.4,42,"Hardin County, Texas",53.8,34,falling,55865,48,199,53.8,66.4
TX,"Harris County, Texas",774568,348592,425976,48201,54457,62126,38401,47894,70349,42451,1618879,533586,1696701,486665,3315580,1020251,"Harris County, Texas(6,10)",56,1768,"Harris County, Texas",40.3,"1,243",falling,4538028,48,201,40.3,56
TX,"Harrison County, Texas",11151,5009,6142,48203,45974,53337,30366,22560,66023,36680,26040,6171,27465,6090,53505,12261,"Harrison County, Texas(6,10)",79.5,62,"Harrison County, Texas",60,45,stable,66746,48,203,60,79.5
TX,"Hartley County, Texas",295,123,172,48205,63004,64798,NA,NA,NA,39444,1984,342,1959,339,3943,681,"Hartley County, Texas(6,10)",*,3 or fewer,"Hartley County, Texas",*,*,**,6193,48,205,NA,NA
TX,"Haskell County, Texas",1030,467,563,48207,39850,39474,18362,NA,NA,28125,2190,440,1988,403,4178,843,"Haskell County, Texas(6,10)",40.6,4,"Haskell County, Texas",60.1,5,stable,5737,48,207,60.1,40.6
TX,"Hays County, Texas",28783,12839,15944,48209,58583,60918,56134,96507,56364,46510,71610,15558,77014,11636,148624,27194,"Hays County, Texas(6,10)",47.2,57,"Hays County, Texas",36.1,44,falling,194739,48,209,36.1,47.2
TX,"Hemphill County, Texas",502,266,236,48211,62813,64406,NA,140500,NA,29773,1552,448,1536,527,3088,975,"Hemphill County, Texas(6,10)",86.4,3,"Hemphill County, Texas",76.3,3,**,4264,48,211,76.3,86.4
TX,"Henderson County, Texas",14572,6271,8301,48213,41607,42358,31667,44167,36707,31171,29559,8648,32037,7881,61596,16529,"Henderson County, Texas(6,10)",89.9,104,"Henderson County, Texas",60.2,70,falling,79545,48,213,60.2,89.9
TX,"Hidalgo County, Texas",277104,126943,150161,48215,34782,34878,51076,34727,75781,32103,257222,135536,272464,146125,529686,281661,"Hidalgo County, Texas(6,10)",32.7,200,"Hidalgo County, Texas",22.5,137,falling,842304,48,215,22.5,32.7
TX,"Hill County, Texas",7049,3091,3958,48217,41382,43319,19859,27500,NA,34766,13420,3402,13665,3769,27085,7171,"Hill County, Texas(6,10)",69.9,35,"Hill County, Texas",63.1,31,stable,34855,48,217,63.1,69.9
TX,"Hockley County, Texas",3297,1407,1890,48219,50665,51301,25500,NA,NA,46377,8887,2518,9184,2584,18071,5102,"Hockley County, Texas(6,10)",51.8,13,"Hockley County, Texas",35,8,falling,23433,48,219,35,51.8
TX,"Hood County, Texas",6161,2476,3685,48221,56100,57151,NA,NA,47917,36725,21323,4472,22328,4299,43651,8771,"Hood County, Texas(6,10)",64.2,56,"Hood County, Texas",47.9,42,falling,55423,48,221,47.9,64.2
TX,"Hopkins County, Texas",6972,2980,3992,48223,44396,46415,30600,43194,NA,36287,13492,3928,13916,3871,27408,7799,"Hopkins County, Texas(6,10)",66,29,"Hopkins County, Texas",49,22,stable,36223,48,223,49,66
TX,"Houston County, Texas",4918,1850,3068,48225,32698,43824,18939,NA,NA,22292,7507,1746,8766,1747,16273,3493,"Houston County, Texas(6,10)",63.1,22,"Houston County, Texas",47.4,16,stable,22785,48,225,47.4,63.1
TX,"Howard County, Texas",4787,1873,2914,48227,49575,51215,28917,45263,66944,38072,12648,2774,12681,2779,25329,5553,"Howard County, Texas(6,10)",73.3,28,"Howard County, Texas",46.9,18,falling,37206,48,227,46.9,73.3
TX,"Hudspeth County, Texas",1192,491,701,48229,26384,26607,NA,NA,NA,21496,1042,336,1171,410,2213,746,"Hudspeth County, Texas(6,10)",*,3 or fewer,"Hudspeth County, Texas",*,*,**,3379,48,229,NA,NA
TX,"Hunt County, Texas",16112,7513,8599,48231,45197,49548,26572,NA,37315,33458,34231,8835,36106,8048,70337,16883,"Hunt County, Texas(6,10)",80.2,82,"Hunt County, Texas",63.1,63,stable,89844,48,231,63.1,80.2
TX,"Hutchinson County, Texas",3493,1394,2099,48233,49353,51078,20868,15000,NA,36958,9028,1827,8766,2079,17794,3906,"Hutchinson County, Texas(6,10)",58.4,15,"Hutchinson County, Texas",45.3,12,falling,21734,48,233,45.3,58.4
TX,"Irion County, Texas",191,84,107,48235,58500,58833,NA,NA,NA,53000,667,157,679,139,1346,296,"Irion County, Texas(6,10)",*,3 or fewer,"Irion County, Texas",*,*,**,1554,48,235,NA,NA
TX,"Jack County, Texas",1324,576,748,48237,50324,50023,61563,61071,NA,36504,3106,830,3066,731,6172,1561,"Jack County, Texas(6,10)",68,7,"Jack County, Texas",54.1,6,stable,8878,48,237,54.1,68
TX,"Jackson County, Texas",1765,582,1183,48239,54926,57193,43523,NA,NA,48702,5925,1003,6262,1059,12187,2062,"Jackson County, Texas(6,10)",57.5,11,"Jackson County, Texas",51.8,10,stable,14816,48,239,51.8,57.5
TX,"Jasper County, Texas",5912,2342,3570,48241,40820,47180,19221,NA,NA,32548,13089,3502,14946,3329,28035,6831,"Jasper County, Texas(6,10)",60.3,29,"Jasper County, Texas",53,25,falling,35506,48,241,53,60.3
TX,"Jeff Davis County, Texas",123,60,63,48243,50165,49395,NA,38750,NA,45250,852,206,801,310,1653,516,"Jeff Davis County, Texas(6,10)",*,3 or fewer,"Jeff Davis County, Texas",*,*,**,2156,48,243,NA,NA
TX,"Jefferson County, Texas",47095,19637,27458,48245,43540,53015,29991,60238,51282,42270,89861,26481,96227,26458,186088,52939,"Jefferson County, Texas(6,10)",65.7,178,"Jefferson County, Texas",49.8,134,falling,254308,48,245,49.8,65.7
TX,"Jim Hogg County, Texas",915,479,436,48247,35521,36979,NA,NA,NA,34350,1827,803,2053,533,3880,1336,"Jim Hogg County, Texas(6,10)",*,3 or fewer,"Jim Hogg County, Texas",*,*,**,5200,48,247,NA,NA
TX,"Jim Wells County, Texas",9128,4274,4854,48249,42986,44526,58472,33438,NA,40919,15575,4670,16196,4620,31771,9290,"Jim Wells County, Texas(6,10)",40.7,18,"Jim Wells County, Texas",35.4,16,falling,41382,48,249,35.4,40.7
TX,"Johnson County, Texas",18392,7958,10434,48251,58135,59027,45385,39583,38486,45706,59557,16156,61348,15792,120905,31948,"Johnson County, Texas(6,10)",71.5,109,"Johnson County, Texas",56.1,86,falling,159990,48,251,56.1,71.5
TX,"Jones County, Texas",2285,894,1391,48253,43897,44653,20332,64583,NA,43142,4378,973,5783,1398,10161,2371,"Jones County, Texas(6,10)",60.1,14,"Jones County, Texas",48.5,11,stable,19970,48,253,48.5,60.1
TX,"Karnes County, Texas",3079,1427,1652,48255,45502,50851,NA,NA,NA,39315,5180,1052,5187,770,10367,1822,"Karnes County, Texas(6,10)",72,12,"Karnes County, Texas",41.1,7,stable,14975,48,255,41.1,72
TX,"Kaufman County, Texas",15016,6368,8648,48257,60391,64298,40484,NA,112625,44972,42193,10864,45071,10169,87264,21033,"Kaufman County, Texas(6,10)",79.4,78,"Kaufman County, Texas",54.7,53,falling,114690,48,257,54.7,79.4
TX,"Kendall County, Texas",2862,1312,1550,48259,73240,75586,66976,NA,NA,51215,15599,2200,16888,2215,32487,4415,"Kendall County, Texas(6,10)",44,21,"Kendall County, Texas",29.5,14,falling,40384,48,259,29.5,44
TX,"Kenedy County, Texas",151,67,84,48261,36438,36313,NA,NA,NA,35063,198,97,192,78,390,175,"Kenedy County, Texas(6,10)",*,3 or fewer,"Kenedy County, Texas",*,*,**,407,48,261,NA,NA
TX,"Kent County, Texas",74,31,43,48263,47024,52031,NA,NA,NA,NA,342,64,325,40,667,104,"Kent County, Texas(6,10)",*,3 or fewer,"Kent County, Texas",*,*,**,764,48,263,NA,NA
TX,"Kerr County, Texas",7718,3243,4475,48265,43810,44381,36250,NA,NA,36849,19403,4288,20616,4902,40019,9190,"Kerr County, Texas(6,10)",53.9,49,"Kerr County, Texas",46.2,43,falling,50955,48,265,46.2,53.9
TX,"Kimble County, Texas",912,401,511,48267,40125,40089,NA,NA,NA,28958,1637,572,1700,518,3337,1090,"Kimble County, Texas(6,10)",58.6,5,"Kimble County, Texas",59.2,5,stable,4388,48,267,59.2,58.6
TX,"King County, Texas",19,10,9,48269,63250,63500,NA,NA,NA,NA,87,49,120,11,207,60,"King County, Texas(6,10)",*,3 or fewer,"King County, Texas",*,*,**,282,48,269,NA,NA
TX,"Kinney County, Texas",572,280,292,48271,38281,39115,23750,NA,NA,40625,1293,445,1131,354,2424,799,"Kinney County, Texas(6,10)",*,3 or fewer,"Kinney County, Texas",*,*,**,3549,48,271,NA,NA
TX,"Kleberg County, Texas",7849,3836,4013,48273,38247,39651,38167,NA,NA,34202,12628,3469,11798,3467,24426,6936,"Kleberg County, Texas(6,10)",53.1,16,"Kleberg County, Texas",36.8,11,stable,31857,48,273,36.8,53.1
TX,"Knox County, Texas",605,223,382,48275,40493,43259,23365,NA,NA,34688,1500,326,1457,384,2957,710,"Knox County, Texas(6,10)",67.1,4,"Knox County, Texas",*,*,**,3860,48,275,NA,67.1
TX,"Lamar County, Texas",9076,3850,5226,48277,40748,44875,24327,29107,NA,41275,19257,4479,20227,4937,39484,9416,"Lamar County, Texas(6,10)",78.4,50,"Lamar County, Texas",55.7,36,falling,49440,48,277,55.7,78.4
TX,"Lamb County, Texas",3173,1511,1662,48279,39851,41176,27813,NA,NA,32875,5326,1561,5166,1487,10492,3048,"Lamb County, Texas(6,10)",41,7,"Lamb County, Texas",31.1,5,stable,13385,48,279,31.1,41
TX,"Lampasas County, Texas",2923,1347,1576,48281,49630,49658,92665,92865,34643,34315,7621,1924,8352,1832,15973,3756,"Lampasas County, Texas(6,10)",74.1,19,"Lampasas County, Texas",66.5,17,stable,20588,48,281,66.5,74.1
TX,"La Salle County, Texas",972,456,516,48283,37292,40604,NA,NA,NA,32957,2213,983,2280,814,4493,1797,"La Salle County, Texas(6,10)",*,3 or fewer,"La Salle County, Texas",*,*,**,7631,48,283,NA,NA
TX,"Lavaca County, Texas",1765,684,1081,48285,48677,52666,25592,NA,NA,43311,7766,1495,8471,1382,16237,2877,"Lavaca County, Texas(6,10)",55.3,17,"Lavaca County, Texas",33.9,11,stable,19836,48,285,33.9,55.3
TX,"Lee County, Texas",2374,1078,1296,48287,53902,55669,33060,NA,NA,55409,6798,1244,6613,1521,13411,2765,"Lee County, Texas(6,10)",44,9,"Lee County, Texas",29.9,6,stable,16898,48,287,29.9,44
TX,"Leon County, Texas",2322,990,1332,48289,49802,50686,31250,NA,108021,37731,6688,1571,6745,1716,13433,3287,"Leon County, Texas(6,10)",67.1,19,"Leon County, Texas",62.7,17,stable,17086,48,289,62.7,67.1
TX,"Liberty County, Texas",12548,5484,7064,48291,48729,51266,25265,47563,NA,42359,27695,8434,27444,7858,55139,16292,"Liberty County, Texas(6,10)",84.3,64,"Liberty County, Texas",69.4,52,falling,79654,48,291,69.4,84.3
TX,"Limestone County, Texas",5189,2600,2589,48293,37554,39671,28309,35000,72083,33864,8344,3005,8787,2345,17131,5350,"Limestone County, Texas(6,10)",81.8,24,"Limestone County, Texas",57.9,17,falling,23320,48,293,57.9,81.8
TX,"Lipscomb County, Texas",317,120,197,48295,63125,62432,NA,NA,NA,64583,1508,341,1254,335,2762,676,"Lipscomb County, Texas(6,10)",*,3 or fewer,"Lipscomb County, Texas",*,*,*,3569,48,295,NA,NA
TX,"Live Oak County, Texas",1567,738,829,48297,50400,49554,NA,NA,NA,35500,4064,886,4176,1158,8240,2044,"Live Oak County, Texas(6,10)",49.4,9,"Live Oak County, Texas",45.3,8,stable,12229,48,297,45.3,49.4
TX,"Llano County, Texas",2841,1108,1733,48299,48259,48269,NA,NA,NA,38472,7598,1502,8376,1594,15974,3096,"Llano County, Texas(6,10)",53.4,24,"Llano County, Texas",42.3,19,falling,19796,48,299,42.3,53.4
TX,"Loving County, Texas",33,24,9,48301,NA,NA,NA,NA,NA,NA,53,21,33,10,86,31,"Loving County, Texas(6,10)",*,3 or fewer,"Loving County, Texas",*,*,**,112,48,301,NA,NA
TX,"Lubbock County, Texas",54155,24959,29196,48303,46075,48573,30616,37422,47363,38703,115181,25530,121041,24799,236222,50329,"Lubbock County, Texas(6,10)",53.2,139,"Lubbock County, Texas",39.3,102,falling,299453,48,303,39.3,53.2
TX,"Lynn County, Texas",1106,451,655,48305,39526,39490,NA,117778,NA,28438,2195,677,2271,590,4466,1267,"Lynn County, Texas(6,10)",47.9,4,"Lynn County, Texas",45.7,3,**,5724,48,305,45.7,47.9
TX,"McCulloch County, Texas",1522,645,877,48307,40561,42052,70042,21212,NA,34136,3306,740,3409,691,6715,1431,"McCulloch County, Texas(6,10)",56,7,"McCulloch County, Texas",40.8,6,stable,8341,48,307,40.8,56
TX,"McLennan County, Texas",49881,22723,27158,48309,42687,47973,24579,39375,26190,34024,93849,21068,102138,20131,195987,41199,"McLennan County, Texas(6,10)",66.1,164,"McLennan County, Texas",52.7,130,falling,245671,48,309,52.7,66.1
TX,"McMullen County, Texas",92,45,47,48311,46250,46429,NA,NA,NA,37083,341,64,349,24,690,88,"McMullen County, Texas(6,10)",*,3 or fewer,"McMullen County, Texas",*,*,**,820,48,311,NA,NA
TX,"Madison County, Texas",1938,925,1013,48313,39390,43257,19863,NA,NA,29679,3731,850,4045,1023,7776,1873,"Madison County, Texas(6,10)",53.7,8,"Madison County, Texas",49.9,8,stable,14065,48,313,49.9,53.7
TX,"Marion County, Texas",2264,742,1522,48315,34175,39071,21863,NA,NA,90375,3761,1077,4209,1053,7970,2130,"Marion County, Texas(6,10)",88.8,16,"Marion County, Texas",80.3,14,stable,10160,48,315,80.3,88.8
TX,"Martin County, Texas",692,335,357,48317,55682,68466,NA,NA,NA,45846,1974,612,1847,754,3821,1366,"Martin County, Texas(6,10)",*,3 or fewer,"Martin County, Texas",*,*,**,5641,48,317,NA,NA
TX,"Mason County, Texas",577,284,293,48319,37654,38500,NA,NA,NA,31250,1535,652,1463,407,2998,1059,"Mason County, Texas(6,10)",*,3 or fewer,"Mason County, Texas",*,*,**,4032,48,319,NA,NA
TX,"Matagorda County, Texas",7833,3539,4294,48321,40797,43383,30317,21125,NA,32438,13769,4128,14174,4112,27943,8240,"Matagorda County, Texas(6,10)",67.8,31,"Matagorda County, Texas",48.2,21,stable,36770,48,321,48.2,67.8
TX,"Maverick County, Texas",14872,6275,8597,48323,33747,33580,NA,35600,136292,32749,18607,8661,18814,9758,37421,18419,"Maverick County, Texas(6,10)",36.7,17,"Maverick County, Texas",23.1,10,stable,57706,48,323,23.1,36.7
TX,"Medina County, Texas",6656,2989,3667,48325,57338,57596,157917,NA,NA,46857,18545,3569,19705,2956,38250,6525,"Medina County, Texas(6,10)",45.6,24,"Medina County, Texas",36.6,20,stable,48417,48,325,36.6,45.6
TX,"Menard County, Texas",317,114,203,48327,34464,35000,NA,NA,NA,23906,751,290,844,250,1595,540,"Menard County, Texas(6,10)",*,3 or fewer,"Menard County, Texas",*,*,**,2164,48,327,NA,NA
TX,"Midland County, Texas",13238,5140,8098,48329,68806,72099,45183,65917,72764,57997,59415,15246,59879,15709,119294,30955,"Midland County, Texas(6,10)",54,71,"Midland County, Texas",41.9,54,falling,161077,48,329,41.9,54
TX,"Milam County, Texas",4159,1650,2509,48331,38929,41224,23571,38542,NA,35050,9871,1918,10224,1877,20095,3795,"Milam County, Texas(6,10)",65.2,23,"Milam County, Texas",47.1,17,stable,24513,48,331,47.1,65.2
TX,"Mills County, Texas",688,223,465,48333,43920,44063,NA,NA,NA,34732,1887,288,2108,436,3995,724,"Mills County, Texas(6,10)",45,4,"Mills County, Texas",41.1,4,stable,4900,48,333,41.1,45
TX,"Mitchell County, Texas",766,274,492,48335,49870,50741,NA,112500,NA,44667,2548,788,2835,570,5383,1358,"Mitchell County, Texas(6,10)",81.9,8,"Mitchell County, Texas",58.5,6,stable,9067,48,335,58.5,81.9
TX,"Montague County, Texas",2878,1274,1604,48337,46172,46386,NA,NA,NA,32313,7160,2262,7429,2328,14589,4590,"Montague County, Texas(6,10)",92.2,26,"Montague County, Texas",69.9,20,stable,19262,48,337,69.9,92.2
TX,"Montgomery County, Texas",59856,27146,32710,48339,68838,70752,50704,46023,90212,46097,203475,43375,212877,39838,416352,83213,"Montgomery County, Texas(6,10)",61.3,271,"Montgomery County, Texas",47,201,falling,537559,48,339,47,61.3
TX,"Moore County, Texas",4421,2081,2340,48341,49802,51039,49464,26648,41150,45077,9007,2403,8437,2236,17444,4639,"Moore County, Texas(6,10)",65.5,12,"Moore County, Texas",46.1,8,stable,22255,48,341,46.1,65.5
TX,"Morris County, Texas",2346,1000,1346,48343,39453,42213,28611,NA,NA,35865,4990,1057,5323,1189,10313,2246,"Morris County, Texas(6,10)",81.2,16,"Morris County, Texas",70.5,14,stable,12516,48,343,70.5,81.2
TX,"Motley County, Texas",181,89,92,48345,31683,32019,NA,NA,NA,26364,387,209,356,119,743,328,"Motley County, Texas(6,10)",*,3 or fewer,"Motley County, Texas",*,*,**,1148,48,345,NA,NA
TX,"Nacogdoches County, Texas",14752,6761,7991,48347,39538,45084,24897,NA,NA,31076,24195,6779,26244,7459,50439,14238,"Nacogdoches County, Texas(6,10)",74.5,47,"Nacogdoches County, Texas",59.7,37,stable,65664,48,347,59.7,74.5
TX,"Navarro County, Texas",9794,4323,5471,48349,41505,45385,23209,26913,NA,37083,18433,4787,18895,5267,37328,10054,"Navarro County, Texas(6,10)",62.3,35,"Navarro County, Texas",59.9,35,falling,48323,48,349,59.9,62.3
TX,"Newton County, Texas",1798,877,921,48351,38144,41646,28460,NA,NA,75458,5334,1736,5786,1018,11120,2754,"Newton County, Texas(6,10)",65.9,13,"Newton County, Texas",57.8,11,stable,13986,48,351,57.8,65.9
TX,"Nolan County, Texas",3108,1410,1698,48353,37102,39139,16758,68438,NA,29349,6040,1512,5859,1464,11899,2976,"Nolan County, Texas(6,10)",58.9,12,"Nolan County, Texas",58.9,11,stable,15107,48,353,58.9,58.9
TX,"Nueces County, Texas",61965,27065,34900,48355,50337,51341,34805,26863,69540,43720,135715,34184,144940,32292,280655,66476,"Nueces County, Texas(6,10)",51.7,184,"Nueces County, Texas",38.1,134,falling,359715,48,355,38.1,51.7
TX,"Ochiltree County, Texas",1447,605,842,48357,51517,51062,NA,NA,NA,50903,4160,1228,3919,1275,8079,2503,"Ochiltree County, Texas(6,10)",60.4,5,"Ochiltree County, Texas",56.4,5,stable,10747,48,357,56.4,60.4
TX,"Oldham County, Texas",214,72,142,48359,50893,49750,NA,NA,NA,33750,661,100,780,96,1441,196,"Oldham County, Texas(6,10)",*,3 or fewer,"Oldham County, Texas",*,*,**,2069,48,359,NA,NA
TX,"Orange County, Texas",12691,5723,6968,48361,49763,52240,30454,28750,56731,46875,33263,7689,34818,6744,68081,14433,"Orange County, Texas(6,10)",82.7,80,"Orange County, Texas",61.9,59,falling,84260,48,361,61.9,82.7
TX,"Palo Pinto County, Texas",5425,2473,2952,48363,39516,40484,40188,NA,NA,33967,10384,3285,10729,3244,21113,6529,"Palo Pinto County, Texas(6,10)",80.8,30,"Palo Pinto County, Texas",58.4,22,falling,27895,48,363,58.4,80.8
TX,"Panola County, Texas",3509,1196,2313,48365,50119,54003,24766,NA,NA,39375,9312,2118,10013,2259,19325,4377,"Panola County, Texas(6,10)",70.7,21,"Panola County, Texas",56.6,17,stable,23766,48,365,56.6,70.7
TX,"Parker County, Texas",11785,4602,7183,48367,67288,68066,57727,68125,128594,54976,49667,9106,50821,9399,100488,18505,"Parker County, Texas(6,10)",70.9,92,"Parker County, Texas",56.9,71,falling,126042,48,367,56.9,70.9
TX,"Parmer County, Texas",1696,751,945,48369,45326,47910,50833,15833,NA,39327,3800,1306,3758,1058,7558,2364,"Parmer County, Texas(6,10)",42,4,"Parmer County, Texas",*,*,**,9749,48,369,NA,42
TX,"Pecos County, Texas",1643,728,915,48371,50305,50792,NA,26635,NA,46679,5464,1551,5490,1261,10954,2812,"Pecos County, Texas(6,10)",40.7,6,"Pecos County, Texas",39.5,6,stable,16203,48,371,39.5,40.7
TX,"Polk County, Texas",7279,3252,4027,48373,39662,41103,30872,34545,41014,33233,16766,4163,16862,4307,33628,8470,"Polk County, Texas(6,10)",99.4,67,"Polk County, Texas",73.4,49,stable,46972,48,373,73.4,99.4
TX,"Potter County, Texas",25466,10956,14510,48375,38159,40634,25489,35278,43443,34613,42602,14415,45405,13402,88007,27817,"Potter County, Texas(6,10)",73.3,83,"Potter County, Texas",46.9,53,falling,121802,48,375,46.9,73.3
TX,"Presidio County, Texas",1586,643,943,48377,32132,31323,NA,NA,NA,26462,2424,1181,2368,1331,4792,2512,"Presidio County, Texas(6,10)",*,3 or fewer,"Presidio County, Texas",*,*,**,6876,48,377,NA,NA
TX,"Rains County, Texas",1206,514,692,48379,48448,48797,26563,NA,250001,26371,4399,1209,4318,1044,8717,2253,"Rains County, Texas(6,10)",87.5,15,"Rains County, Texas",59.9,11,falling,11161,48,379,59.9,87.5
TX,"Randall County, Texas",13076,5425,7651,48381,60972,61373,46541,79250,63707,49408,53379,8330,56164,8041,109543,16371,"Randall County, Texas(6,10)",52.8,68,"Randall County, Texas",38.1,49,falling,130269,48,381,38.1,52.8
TX,"Reagan County, Texas",552,277,275,48383,52181,69231,16250,NA,NA,50509,1249,595,1150,572,2399,1167,"Reagan County, Texas(6,10)",*,3 or fewer,"Reagan County, Texas",*,*,**,3792,48,383,NA,NA
TX,"Real County, Texas",541,242,299,48385,36523,36797,NA,NA,NA,27400,1270,354,1232,409,2502,763,"Real County, Texas(6,10)",49.4,3,"Real County, Texas",56.7,4,**,3307,48,385,56.7,49.4
TX,"Red River County, Texas",2321,1053,1268,48387,31563,34183,19135,40000,NA,11946,4706,1311,5175,1168,9881,2479,"Red River County, Texas(6,10)",67,14,"Red River County, Texas",51.5,11,stable,12455,48,387,51.5,67
TX,"Reeves County, Texas",1895,825,1070,48389,43540,43563,NA,43219,NA,38071,4368,860,4883,1253,9251,2113,"Reeves County, Texas(6,10)",35.8,5,"Reeves County, Texas",23.6,3,**,14732,48,389,23.6,35.8
TX,"Refugio County, Texas",1203,573,630,48391,44240,47406,39034,NA,NA,35000,2911,661,2944,602,5855,1263,"Refugio County, Texas(6,10)",79.8,9,"Refugio County, Texas",69.5,8,stable,7289,48,391,69.5,79.8
TX,"Roberts County, Texas",14,9,5,48393,63889,64722,NA,NA,NA,NA,384,58,414,75,798,133,"Roberts County, Texas(6,10)",*,3 or fewer,"Roberts County, Texas",*,*,**,916,48,393,NA,NA
TX,"Robertson County, Texas",2841,1286,1555,48395,46501,51483,18716,72857,NA,48068,6344,1812,6681,1499,13025,3311,"Robertson County, Texas(6,10)",58.2,13,"Robertson County, Texas",53.6,12,stable,16659,48,395,53.6,58.2
TX,"Rockwall County, Texas",5310,2397,2913,48397,87524,89717,69349,93875,130909,53052,36281,5253,38024,5226,74305,10479,"Rockwall County, Texas(6,10)",49.2,34,"Rockwall County, Texas",34.8,24,falling,90861,48,397,34.8,49.2
TX,"Runnels County, Texas",2071,964,1107,48399,41526,43455,11399,NA,NA,37067,4146,935,4227,928,8373,1863,"Runnels County, Texas(6,10)",61.1,10,"Runnels County, Texas",49.8,8,falling,10551,48,399,49.8,61.1
TX,"Rusk County, Texas",8510,3598,4912,48401,46173,50962,23617,NA,67250,40584,18852,5291,19359,5367,38211,10658,"Rusk County, Texas(6,10)",69.8,43,"Rusk County, Texas",51.6,33,stable,53070,48,401,51.6,69.8
TX,"Sabine County, Texas",2840,1363,1477,48403,31307,33434,15350,NA,NA,NA,3777,1276,4130,1174,7907,2450,"Sabine County, Texas(6,10)",71.3,16,"Sabine County, Texas",51.8,11,falling,10368,48,403,51.8,71.3
TX,"San Augustine County, Texas",2105,978,1127,48405,28275,31232,16397,36250,NA,30781,3122,964,3314,1087,6436,2051,"San Augustine County, Texas(6,10)",73.8,11,"San Augustine County, Texas",65.6,10,stable,8473,48,405,65.6,73.8
TX,"San Jacinto County, Texas",5419,2160,3259,48407,43029,44744,30494,NA,15795,47143,10737,2597,10586,2956,21323,5553,"San Jacinto County, Texas(6,10)",93,34,"San Jacinto County, Texas",75.2,28,stable,27413,48,407,75.2,93
TX,"San Patricio County, Texas",9949,4153,5796,48409,52261,52569,28250,43092,83821,46773,25544,6973,26358,6379,51902,13352,"San Patricio County, Texas(6,10)",73.5,51,"San Patricio County, Texas",55.7,39,falling,67357,48,409,55.7,73.5
TX,"San Saba County, Texas",792,416,376,48411,39040,39200,NA,NA,NA,36012,2429,513,2000,298,4429,811,"San Saba County, Texas(6,10)",60.9,6,"San Saba County, Texas",51.7,5,stable,5901,48,411,51.7,60.9
TX,"Schleicher County, Texas",630,214,416,48413,55543,56083,NA,NA,NA,45375,1188,394,1217,425,2405,819,"Schleicher County, Texas(6,10)",*,3 or fewer,"Schleicher County, Texas",*,*,**,3211,48,413,NA,NA
TX,"Scurry County, Texas",1527,555,972,48415,56842,57184,90341,NA,NA,47207,6772,1109,6466,1407,13238,2516,"Scurry County, Texas(6,10)",76.8,14,"Scurry County, Texas",53.2,10,stable,17615,48,415,53.2,76.8
TX,"Shackelford County, Texas",635,340,295,48417,48750,47661,NA,NA,NA,37083,1309,307,1413,304,2722,611,"Shackelford County, Texas(6,10)",*,3 or fewer,"Shackelford County, Texas",*,*,**,3350,48,417,NA,NA
TX,"Shelby County, Texas",5553,2706,2847,48419,37756,42157,21458,NA,NA,35156,9184,3301,9996,3064,19180,6365,"Shelby County, Texas(6,10)",73.4,23,"Shelby County, Texas",60,19,falling,25402,48,419,60,73.4
TX,"Sherman County, Texas",376,117,259,48421,51987,52857,NA,NA,NA,37917,1143,410,1167,303,2310,713,"Sherman County, Texas(6,10)",*,3 or fewer,"Sherman County, Texas",*,*,**,3072,48,421,NA,NA
TX,"Smith County, Texas",37048,16944,20104,48423,46929,51908,30632,42154,51044,37376,82135,21568,91107,20424,173242,41992,"Smith County, Texas(6,10)",67.3,166,"Smith County, Texas",47.8,118,stable,222936,48,423,47.8,67.3
TX,"Somervell County, Texas",1158,406,752,48425,51912,51282,NA,NA,NA,42257,3218,875,3453,874,6671,1749,"Somervell County, Texas(6,10)",62,6,"Somervell County, Texas",44.5,5,falling,8739,48,425,44.5,62
TX,"Starr County, Texas",22663,9955,12708,48427,26172,26318,NA,NA,NA,25961,18529,11332,20213,12022,38742,23354,"Starr County, Texas(6,10)",38.5,20,"Starr County, Texas",25.4,13,stable,63795,48,427,25.4,38.5
TX,"Stephens County, Texas",1751,749,1002,48429,43951,44296,27292,NA,NA,35125,3528,915,3147,1191,6675,2106,"Stephens County, Texas(6,10)",83.7,11,"Stephens County, Texas",68.9,9,stable,9440,48,429,68.9,83.7
TX,"Sterling County, Texas",208,100,108,48431,53456,55750,NA,NA,NA,60481,501,179,472,156,973,335,"Sterling County, Texas(6,10)",*,3 or fewer,"Sterling County, Texas",*,*,**,1352,48,431,NA,NA
TX,"Stonewall County, Texas",264,155,109,48433,42155,46310,NA,NA,NA,35909,568,113,571,111,1139,224,"Stonewall County, Texas(6,10)",*,3 or fewer,"Stonewall County, Texas",*,*,**,1410,48,433,NA,NA
TX,"Sutton County, Texas",328,151,177,48435,51667,54500,NA,NA,NA,47106,1496,515,1329,601,2825,1116,"Sutton County, Texas(6,10)",*,3 or fewer,"Sutton County, Texas",*,*,**,3913,48,435,NA,NA
TX,"Swisher County, Texas",1595,708,887,48437,37040,40489,18897,41111,44821,29886,2853,616,3068,567,5921,1183,"Swisher County, Texas(6,10)",49.7,5,"Swisher County, Texas",36.7,4,**,7533,48,437,36.7,49.7
TX,"Tarrant County, Texas",283264,129036,154228,48439,58711,63883,41735,61065,62265,43986,739469,189027,793135,177419,1532604,366446,"Tarrant County, Texas(6,10)",60.2,903,"Tarrant County, Texas",44.4,654,falling,1982498,48,439,44.4,60.2
TX,"Taylor County, Texas",22395,9712,12683,48441,45396,47737,34037,52847,27295,38182,51598,10570,56226,11336,107824,21906,"Taylor County, Texas(6,10)",60.3,85,"Taylor County, Texas",46.8,67,falling,136051,48,441,46.8,60.3
TX,"Terrell County, Texas",186,58,128,48443,31111,42188,NA,NA,NA,27647,363,67,416,75,779,142,"Terrell County, Texas(6,10)",*,3 or fewer,"Terrell County, Texas",*,*,**,837,48,443,NA,NA
TX,"Terry County, Texas",1756,726,1030,48445,37475,38984,NA,NA,NA,32338,4344,1483,4434,1352,8778,2835,"Terry County, Texas(6,10)",70.7,10,"Terry County, Texas",52.9,8,stable,12739,48,445,52.9,70.7
TX,"Throckmorton County, Texas",199,81,118,48447,41042,43333,NA,NA,NA,52353,585,135,639,175,1224,310,"Throckmorton County, Texas(6,10)",*,3 or fewer,"Throckmorton County, Texas",*,*,**,1579,48,447,NA,NA
TX,"Titus County, Texas",6848,3136,3712,48449,44178,47468,26462,49345,105625,37860,12377,3575,12702,3605,25079,7180,"Titus County, Texas(6,10)",49.2,15,"Titus County, Texas",45,14,falling,32623,48,449,45,49.2
TX,"Tom Green County, Texas",16202,7037,9165,48451,46711,47917,28638,40417,61029,37978,43247,10045,46420,10234,89667,20279,"Tom Green County, Texas(6,10)",54.1,67,"Tom Green County, Texas",41.5,52,falling,118105,48,451,41.5,54.1
TX,"Travis County, Texas",180220,84267,95953,48453,61451,65193,42404,50083,77831,42788,454074,106121,467836,86190,921910,192311,"Travis County, Texas(6,10)",44.8,330,"Travis County, Texas",32.6,230,falling,1176558,48,453,32.6,44.8
TX,"Trinity County, Texas",2381,1166,1215,48455,34295,36804,19808,NA,NA,31923,5485,1489,5866,1491,11351,2980,"Trinity County, Texas(6,10)",90.7,23,"Trinity County, Texas",74.7,19,stable,14402,48,455,74.7,90.7
TX,"Tyler County, Texas",3159,1489,1670,48457,41360,42113,27337,NA,NA,23373,7657,1696,8058,1627,15715,3323,"Tyler County, Texas(6,10)",72.8,23,"Tyler County, Texas",60.6,19,stable,21347,48,457,60.6,72.8
TX,"Upshur County, Texas",5322,2251,3071,48459,46673,48697,35148,NA,NA,35365,16130,3570,16157,3745,32287,7315,"Upshur County, Texas(6,10)",75.5,39,"Upshur County, Texas",57.6,29,stable,40603,48,459,57.6,75.5
TX,"Upton County, Texas",657,278,379,48461,46131,56510,NA,NA,NA,34837,1214,378,1316,439,2530,817,"Upton County, Texas(6,10)",*,3 or fewer,"Upton County, Texas",89.1,3,**,3651,48,461,89.1,NA
TX,"Uvalde County, Texas",5248,2307,2941,48463,38568,38432,NA,NA,250001,32373,9925,3035,10651,2984,20576,6019,"Uvalde County, Texas(6,10)",38.1,12,"Uvalde County, Texas",32.7,10,falling,27245,48,463,32.7,38.1
TX,"Val Verde County, Texas",9738,4303,5435,48465,42174,42015,47074,43438,NA,39710,17516,5036,17926,5882,35442,10918,"Val Verde County, Texas(6,10)",35.4,17,"Val Verde County, Texas",31.3,15,falling,48988,48,465,31.3,35.4
TX,"Van Zandt County, Texas",8787,3991,4796,48467,44002,44872,43681,NA,22177,35561,20005,5621,21102,5344,41107,10965,"Van Zandt County, Texas(6,10)",68.7,52,"Van Zandt County, Texas",57.5,42,stable,53547,48,467,57.5,68.7
TX,"Victoria County, Texas",14531,6219,8312,48469,51758,53785,37089,NA,95117,41575,35369,8179,36915,8540,72284,16719,"Victoria County, Texas(6,10)",57.6,56,"Victoria County, Texas",39.5,38,falling,92382,48,469,39.5,57.6
TX,"Walker County, Texas",12642,5139,7503,48471,37666,42535,25845,NA,54293,27708,19845,3706,24287,4320,44132,8026,"Walker County, Texas(6,10)",68.5,43,"Walker County, Texas",46.6,28,falling,70699,48,471,46.6,68.5
TX,"Waller County, Texas",7505,3529,3976,48473,51348,60578,33322,NA,NA,39656,17736,5186,17510,5160,35246,10346,"Waller County, Texas(6,10)",53.7,21,"Waller County, Texas",36.9,15,falling,48656,48,473,36.9,53.7
TX,"Ward County, Texas",1831,905,926,48475,51345,51326,39423,NA,NA,49653,4602,906,4370,1217,8972,2123,"Ward County, Texas(6,10)",69.8,9,"Ward County, Texas",57.7,7,stable,11721,48,475,57.7,69.8
TX,"Washington County, Texas",4325,1895,2430,48477,51269,54675,32744,71250,79358,36934,13553,3285,14529,2211,28082,5496,"Washington County, Texas(6,10)",44.7,22,"Washington County, Texas",35.4,17,falling,34765,48,477,35.4,44.7
TX,"Webb County, Texas",82307,36856,45451,48479,38862,38614,123355,45406,89458,37705,85837,40609,91945,42511,177782,83120,"Webb County, Texas(6,10)",30.3,51,"Webb County, Texas",20.7,35,falling,269721,48,479,20.7,30.3
TX,"Wharton County, Texas",7178,3232,3946,48481,45176,48528,26340,NA,NA,38786,15744,4348,16861,4001,32605,8349,"Wharton County, Texas(6,10)",49.7,25,"Wharton County, Texas",39.2,19,stable,41486,48,481,39.2,49.7
TX,"Wheeler County, Texas",862,419,443,48483,52221,54383,42188,NA,208333,39271,2148,673,2094,633,4242,1306,"Wheeler County, Texas(6,10)",54,4,"Wheeler County, Texas",59.1,4,stable,5657,48,483,59.1,54
TX,"Wichita County, Texas",20712,8817,11895,48485,45543,48105,28551,61122,68400,36052,45680,9621,51992,10046,97672,19667,"Wichita County, Texas(6,10)",74.9,106,"Wichita County, Texas",55.8,79,falling,131705,48,485,55.8,74.9
TX,"Wilbarger County, Texas",2275,1155,1120,48487,41630,47349,20221,41071,60652,48859,5337,1132,5308,1217,10645,2349,"Wilbarger County, Texas(6,10)",62.3,11,"Wilbarger County, Texas",43.5,7,stable,13027,48,487,43.5,62.3
TX,"Willacy County, Texas",7604,3426,4178,48489,26495,26310,NA,NA,NA,22447,6349,3273,6820,3070,13169,6343,"Willacy County, Texas(6,10)",40.4,9,"Willacy County, Texas",35.2,7,stable,21903,48,489,35.2,40.4
TX,"Williamson County, Texas",35014,15936,19078,48491,73750,73781,57404,53713,109278,58057,199404,30976,211551,27780,410955,58756,"Williamson County, Texas(6,10)",50.9,178,"Williamson County, Texas",35.5,122,falling,508514,48,491,35.5,50.9
TX,"Wilson County, Texas",4783,2127,2656,48493,68100,69497,46538,NA,NA,51747,19112,3384,19368,2993,38480,6377,"Wilson County, Texas(6,10)",43.7,22,"Wilson County, Texas",35.9,18,falling,47520,48,493,35.9,43.7
TX,"Winkler County, Texas",1040,370,670,48495,55756,56221,46731,NA,NA,57039,2829,879,2766,995,5595,1874,"Winkler County, Texas(6,10)",67.8,5,"Winkler County, Texas",49.1,4,**,8005,48,495,49.1,67.8
TX,"Wise County, Texas",7015,2646,4369,48497,56897,57258,60650,74222,86875,45595,24533,5501,24716,5520,49249,11021,"Wise County, Texas(6,10)",63.1,41,"Wise County, Texas",55.2,35,stable,62953,48,497,55.2,63.1
TX,"Wood County, Texas",6073,2621,3452,48499,45686,47046,29028,29226,43125,37617,16976,3633,17291,4003,34267,7636,"Wood County, Texas(6,10)",75.4,57,"Wood County, Texas",57.9,44,stable,43356,48,499,57.9,75.4
TX,"Yoakum County, Texas",979,308,671,48501,56153,57370,NA,NA,NA,57159,3063,1048,3125,966,6188,2014,"Yoakum County, Texas(6,10)",66.2,5,"Yoakum County, Texas",52.8,4,stable,8546,48,501,52.8,66.2
TX,"Young County, Texas",2751,1308,1443,48503,44693,46424,20774,NA,23892,35514,6888,2148,7086,1934,13974,4082,"Young County, Texas(6,10)",74.2,20,"Young County, Texas",60.2,16,stable,18270,48,503,60.2,74.2
TX,"Zapata County, Texas",5334,2552,2782,48505,32162,31974,NA,NA,NA,31379,4838,2306,4663,2467,9501,4773,"Zapata County, Texas(6,10)",38.2,4,"Zapata County, Texas",*,*,*,14374,48,505,NA,38.2
TX,"Zavala County, Texas",3943,1409,2534,48507,26672,24315,NA,NA,NA,25897,4441,1286,4639,1440,9080,2726,"Zavala County, Texas(6,10)",*,3 or fewer,"Zavala County, Texas",*,*,**,12235,48,507,NA,NA
UT,"Beaver County, Utah",797,374,423,49001,50282,50847,NA,NA,NA,32321,2849,421,2673,440,5522,861,"Beaver County, Utah(7)",*,3 or fewer,"Beaver County, Utah",*,*,**,6354,49,1,NA,NA
UT,"Box Elder County, Utah",4779,2317,2462,49003,55038,55631,NA,NA,51607,34719,23124,2303,23051,2112,46175,4415,"Box Elder County, Utah(7,8)",20.4,10,"Box Elder County, Utah",17.6,8,stable,52097,49,3,17.6,20.4
UT,"Cache County, Utah",17713,8262,9451,49005,50497,51159,NA,23878,27155,40308,51912,6142,53168,5493,105080,11635,"Cache County, Utah(7,8)",15.8,12,"Cache County, Utah",9.2,7,stable,120783,49,5,9.2,15.8
UT,"Carbon County, Utah",3113,1350,1763,49007,46900,46921,39904,84219,60938,43387,8742,1467,9307,1195,18049,2662,"Carbon County, Utah(7,8)",51.1,12,"Carbon County, Utah",34.5,8,stable,20479,49,7,34.5,51.1
UT,"Daggett County, Utah",47,11,36,49009,56750,56750,NA,NA,NA,NA,290,10,335,16,625,26,"Daggett County, Utah(7)",*,3 or fewer,"Daggett County, Utah",*,*,**,1109,49,9,NA,NA
UT,"Davis County, Utah",24718,10960,13758,49011,71112,72441,58924,88000,66839,49562,145687,14662,147007,12969,292694,27631,"Davis County, Utah(7,8)",25,57,"Davis County, Utah",17.2,38,falling,336043,49,11,17.2,25
UT,"Duchesne County, Utah",2019,821,1198,49013,61133,61377,NA,45417,100179,60515,8292,1519,8101,1535,16393,3054,"Duchesne County, Utah(7,8)",50.2,8,"Duchesne County, Utah",34.9,6,**,20862,49,13,34.9,50.2
UT,"Emery County, Utah",1188,482,706,49015,49787,49794,NA,NA,NA,24856,4683,715,4601,677,9284,1392,"Emery County, Utah(7,8)",*,3 or fewer,"Emery County, Utah",*,*,**,10370,49,15,NA,NA
UT,"Garfield County, Utah",873,358,515,49017,42614,42386,NA,NA,NA,NA,1979,488,1917,457,3896,945,"Garfield County, Utah(7)",*,3 or fewer,"Garfield County, Utah",*,*,**,5009,49,17,NA,NA
UT,"Grand County, Utah",1740,877,863,49019,41312,41570,NA,46713,NA,24222,3426,1354,3470,1073,6896,2427,"Grand County, Utah(7)",61.9,7,"Grand County, Utah",44.1,5,falling,9516,49,19,44.1,61.9
UT,"Iron County, Utah",9727,4998,4729,49021,43855,45370,NA,25301,91917,22097,18610,4636,19409,4043,38019,8679,"Iron County, Utah(7,8)",29.5,11,"Iron County, Utah",19.7,7,stable,48368,49,21,19.7,29.5
UT,"Juab County, Utah",1464,746,718,49023,54761,55462,NA,31250,NA,50536,4438,868,4299,652,8737,1520,"Juab County, Utah(7)",*,3 or fewer,"Juab County, Utah",*,*,**,10594,49,23,NA,NA
UT,"Kane County, Utah",562,233,329,49025,50194,46956,NA,NA,NA,NA,2577,854,3145,534,5722,1388,"Kane County, Utah(7)",32.6,4,"Kane County, Utah",*,*,**,7131,49,25,NA,32.6
UT,"Millard County, Utah",1602,713,889,49027,51593,55658,NA,NA,NA,29524,5162,1151,5142,975,10304,2126,"Millard County, Utah(7)",25.8,4,"Millard County, Utah",*,*,**,12645,49,27,NA,25.8
UT,"Morgan County, Utah",557,262,295,49029,74314,74755,NA,NA,NA,NA,4663,545,4527,511,9190,1056,"Morgan County, Utah(7)",*,3 or fewer,"Morgan County, Utah",*,*,**,11065,49,29,NA,NA
UT,"Piute County, Utah",376,190,186,49031,35980,36107,NA,NA,NA,22292,793,191,691,151,1484,342,"Piute County, Utah(7)",*,3 or fewer,"Piute County, Utah",*,*,**,1517,49,31,NA,NA
UT,"Rich County, Utah",333,115,218,49033,50781,50938,NA,NA,NA,22344,971,117,995,204,1966,321,"Rich County, Utah(7)",*,3 or fewer,"Rich County, Utah",*,*,**,2311,49,33,NA,NA
UT,"Salt Lake County, Utah",131630,61427,70203,49035,62117,65111,37500,35938,61677,44209,451726,84207,463806,71201,915532,155408,"Salt Lake County, Utah(7,8)",32.1,260,"Salt Lake County, Utah",22.1,177,falling,1107314,49,35,22.1,32.1
UT,"San Juan County, Utah",4149,1972,2177,49037,41484,57593,NA,24132,NA,NA,5357,1973,5604,1951,10961,3924,"San Juan County, Utah(7)",*,3 or fewer,"San Juan County, Utah",*,*,**,15772,49,37,NA,NA
UT,"Sanpete County, Utah",4043,1618,2425,49039,50323,50690,NA,33618,NA,42500,10296,2052,11239,2099,21535,4151,"Sanpete County, Utah(7,8)",29.3,8,"Sanpete County, Utah",18.8,5,stable,28778,49,39,18.8,29.3
UT,"Sevier County, Utah",2973,1222,1751,49041,46291,47404,NA,22216,NA,23929,8616,1742,8384,1772,17000,3514,"Sevier County, Utah(7,8)",30.3,7,"Sevier County, Utah",21.3,5,stable,20984,49,41,21.3,30.3
UT,"Summit County, Utah",3001,1546,1455,49043,91773,92425,47426,NA,135913,39911,17112,2404,16860,2021,33972,4425,"Summit County, Utah(7,8)",18.2,6,"Summit County, Utah",14.4,4,**,39633,49,43,14.4,18.2
UT,"Tooele County, Utah",4339,1877,2462,49045,63552,64735,91471,53056,NA,49444,27050,3351,27218,2768,54268,6119,"Tooele County, Utah(7,8)",40.2,16,"Tooele County, Utah",28.9,12,stable,62952,49,45,28.9,40.2
UT,"Uintah County, Utah",3261,1530,1731,49047,66815,69619,NA,41818,NA,42136,14957,2986,14652,2753,29609,5739,"Uintah County, Utah(7,8)",27.6,7,"Uintah County, Utah",24.3,6,stable,37928,49,47,24.3,27.6
UT,"Utah County, Utah",71110,33388,37722,49049,62180,62884,44643,42825,54917,45308,242176,32950,241635,31570,483811,64520,"Utah County, Utah(7,8)",18.5,56,"Utah County, Utah",12.4,37,falling,575205,49,49,12.4,18.5
UT,"Wasatch County, Utah",2633,1199,1434,49051,66486,67269,NA,NA,NA,45330,11263,2016,11400,1808,22663,3824,"Wasatch County, Utah(7)",34.5,6,"Wasatch County, Utah",23.1,4,**,29161,49,51,23.1,34.5
UT,"Washington County, Utah",21893,10244,11649,49053,50774,51384,27841,42188,51588,35670,59249,13064,62096,12364,121345,25428,"Washington County, Utah(7,8)",29.7,55,"Washington County, Utah",22.5,41,falling,155602,49,53,22.5,29.7
UT,"Wayne County, Utah",414,214,200,49055,40645,41048,NA,NA,NA,34896,1070,327,1076,231,2146,558,"Wayne County, Utah(7)",*,3 or fewer,"Wayne County, Utah",*,*,**,2692,49,55,NA,NA
UT,"Weber County, Utah",30547,14446,16101,49057,56581,58326,34482,35893,53430,38573,100971,16736,102594,15564,203565,32300,"Weber County, Utah(7,8)",33.6,69,"Weber County, Utah",25.4,51,stable,243645,49,57,25.4,33.6
VA,"Accomack County, Virginia",6384,2475,3909,51001,39412,45737,28401,NA,NA,42768,12900,2962,14094,2753,26994,5715,"Accomack County, Virginia(6,10)",91.1,46,"Accomack County, Virginia",76.7,38,stable,32973,51,1,76.7,91.1
VA,"Albemarle County, Virginia",9714,4431,5283,51003,68449,71625,39587,NA,71897,48777,44260,4170,49034,4068,93294,8238,"Albemarle County, Virginia(6,10)",41,49,"Albemarle County, Virginia",34.1,41,falling,105703,51,3,34.1,41
VA,"Alleghany County, Virginia",2682,1184,1498,51005,45007,45865,27500,NA,NA,46583,7093,703,7364,666,14457,1369,"Alleghany County and Clifton Forge City, Virginia(6,10)",54.8,14,"Alleghany County and Clifton Forge City, Virginia",61.3,16,stable,15677,51,5,61.3,54.8
VA,"Amelia County, Virginia",1471,792,679,51007,56850,67579,42746,42798,NA,NA,5483,971,5376,848,10859,1819,"Amelia County, Virginia(6,10)",75.3,13,"Amelia County, Virginia",65.5,11,stable,12903,51,7,65.5,75.3
VA,"Amherst County, Virginia",4086,2099,1987,51009,47558,51276,30625,83125,64886,NA,13171,2199,15012,1588,28183,3787,"Amherst County, Virginia(6,10)",64.7,28,"Amherst County, Virginia",51.8,23,stable,31914,51,9,51.8,64.7
VA,"Appomattox County, Virginia",2668,1172,1496,51011,48823,53854,26786,NA,NA,61875,6642,713,6903,879,13545,1592,"Appomattox County, Virginia(6,10)",75.5,15,"Appomattox County, Virginia",53.8,11,stable,15414,51,11,53.8,75.5
VA,"Arlington County, Virginia",19996,9134,10862,51013,105763,119390,62463,NA,88222,65003,97738,11574,101234,9734,198972,21308,"Arlington County, Virginia(6,10)",37.2,61,"Arlington County, Virginia",26.3,43,falling,229164,51,13,26.3,37.2
VA,"Augusta County, Virginia",6694,2535,4159,51015,54558,55281,30795,24491,NA,46250,30103,3876,32697,3556,62800,7432,"Augusta County, Virginia(6,10)",51.7,53,"Augusta County, Virginia",45.9,46,stable,74314,51,15,45.9,51.7
VA,"Bath County, Virginia",347,185,162,51017,43646,44097,NA,NA,NA,NA,1919,287,1971,344,3890,631,"Bath County, Virginia(6,10)",66,5,"Bath County, Virginia",41.6,4,stable,4470,51,17,41.6,66
VA,"Bland County, Virginia",621,287,334,51021,45294,45315,NA,NA,NA,NA,2578,245,2649,255,5227,500,"Bland County, Virginia(6,10)",83.5,8,"Bland County, Virginia",54.2,5,stable,6561,51,21,54.2,83.5
VA,"Botetourt County, Virginia",2701,1248,1453,51023,60454,60956,50962,NA,NA,62125,15366,893,15919,708,31285,1601,"Botetourt County, Virginia(6,10)",56.4,26,"Botetourt County, Virginia",41.9,20,stable,33347,51,23,41.9,56.4
VA,"Brunswick County, Virginia",3298,1396,1902,51025,36919,46318,29248,NA,NA,37574,6129,1200,7046,841,13175,2041,"Brunswick County, Virginia(6,10)",74.6,18,"Brunswick County, Virginia",46.5,11,falling,16698,51,25,46.5,74.6
VA,"Buchanan County, Virginia",5841,2717,3124,51027,29679,30070,NA,NA,100938,NA,9635,1386,10011,1414,19646,2800,"Buchanan County, Virginia(6,10)",53.9,18,"Buchanan County, Virginia",56.4,19,stable,22776,51,27,56.4,53.9
VA,"Buckingham County, Virginia",2867,1283,1584,51029,40331,41935,35682,NA,NA,101050,6196,1305,6470,1069,12666,2374,"Buckingham County, Virginia(6,10)",76.7,17,"Buckingham County, Virginia",54.2,11,stable,17032,51,29,54.2,76.7
VA,"Campbell County, Virginia",7309,3096,4213,51031,47699,49710,39872,NA,36231,61650,22926,3396,25433,2771,48359,6167,"Campbell County, Virginia(6,10)",54.2,40,"Campbell County, Virginia",47,35,stable,55086,51,31,47,54.2
VA,"Caroline County, Virginia",3601,1521,2080,51033,59227,63107,51291,130648,35938,63487,11117,1658,12880,1543,23997,3201,"Caroline County, Virginia(6,10)",83.6,29,"Caroline County, Virginia",64.6,21,stable,29984,51,33,64.6,83.6
VA,"Carroll County, Virginia",5017,2237,2780,51035,35000,35059,NA,NA,NA,51071,12746,2169,12772,2031,25518,4200,"Carroll County, Virginia(6,10)",56.4,26,"Carroll County, Virginia",55.4,26,stable,29724,51,35,55.4,56.4
VA,"Charles City County, Virginia",933,379,554,51036,49563,61955,40891,63500,NA,93750,3040,478,3211,366,6251,844,"Charles City County, Virginia(6,10)",51.9,7,"Charles City County, Virginia",55.6,7,falling,7040,51,36,55.6,51.9
VA,"Charlotte County, Virginia",2589,1050,1539,51037,35079,38106,25353,NA,NA,NA,5037,994,5142,1002,10179,1996,"Charlotte County, Virginia(6,10)",59.5,11,"Charlotte County, Virginia",42.1,8,stable,12201,51,37,42.1,59.5
VA,"Chesterfield County, Virginia",24002,10156,13846,51041,72609,76423,62131,39375,83229,50016,140593,15440,154425,14959,295018,30399,"Chesterfield County, Virginia(6,10)",69.4,211,"Chesterfield County, Virginia",47.6,143,falling,335687,51,41,47.6,69.4
VA,"Clarke County, Virginia",1556,734,822,51043,71295,75668,32153,NA,NA,NA,6011,910,6253,930,12264,1840,"Clarke County, Virginia(6,10)",63.4,13,"Clarke County, Virginia",64.9,13,stable,14363,51,43,64.9,63.4
VA,"Craig County, Virginia",611,218,393,51045,44330,44263,NA,NA,NA,NA,2140,345,2461,249,4601,594,"Craig County, Virginia(6,10)",58.9,5,"Craig County, Virginia",54,4,**,5211,51,45,54,58.9
VA,"Culpeper County, Virginia",4320,1806,2514,51047,66697,70034,52992,NA,92222,47100,19760,3129,21227,2709,40987,5838,"Culpeper County, Virginia(6,10)",70.6,35,"Culpeper County, Virginia",54.3,26,falling,49432,51,47,54.3,70.6
VA,"Cumberland County, Virginia",1996,1065,931,51049,39301,43476,29350,NA,NA,NA,3922,1018,4156,763,8078,1781,"Cumberland County, Virginia(6,10)",64.8,9,"Cumberland County, Virginia",59.2,8,stable,9719,51,49,59.2,64.8
VA,"Dickenson County, Virginia",3225,1513,1712,51051,33624,33638,24000,NA,NA,NA,6679,911,6684,794,13363,1705,"Dickenson County, Virginia(6,10)",76.1,17,"Dickenson County, Virginia",71.6,16,stable,15115,51,51,71.6,76.1
VA,"Dinwiddie County, Virginia",4061,1686,2375,51053,51397,53457,41832,NA,123250,68669,12015,1568,12668,1434,24683,3002,"Dinwiddie County, Virginia(6,10)",70.9,24,"Dinwiddie County, Virginia",55,19,stable,27852,51,53,55,70.9
VA,"Essex County, Virginia",1533,584,949,51057,42760,48322,36791,67841,NA,NA,4431,704,5217,723,9648,1427,"Essex County, Virginia(6,10)",81.5,13,"Essex County, Virginia",61.8,10,stable,11130,51,57,61.8,81.5
VA,"Fairfax County, Virginia",66762,29498,37264,51059,112552,123313,81908,68824,106700,75045,484051,64076,509943,57197,993994,121273,"Fairfax County, Virginia(6,10)",40,390,"Fairfax County, Virginia",25.6,242,falling,1142234,51,59,25.6,40
VA,"Fauquier County, Virginia",3762,1662,2100,51061,91609,95425,47431,114306,90278,63967,29662,3417,31138,2792,60800,6209,"Fauquier County, Virginia(6,10)",48.7,37,"Fauquier County, Virginia",41.3,30,falling,68782,51,61,41.3,48.7
VA,"Floyd County, Virginia",1551,803,748,51063,48005,50096,18365,NA,NA,36875,6874,900,6930,731,13804,1631,"Floyd County, Virginia(6,10)",47.5,10,"Floyd County, Virginia",38.8,8,stable,15651,51,63,38.8,47.5
VA,"Fluvanna County, Virginia",1618,666,952,51065,63938,65405,56350,NA,NA,36603,10621,1184,11949,956,22570,2140,"Fluvanna County, Virginia(6,10)",66.4,22,"Fluvanna County, Virginia",39.4,13,stable,26235,51,65,39.4,66.4
VA,"Franklin County, Virginia",8123,3695,4428,51067,46870,48167,38289,16635,NA,30711,23707,3737,24950,3592,48657,7329,"Franklin County, Virginia(6,10)",53.1,42,"Franklin County, Virginia",43.4,34,stable,56264,51,67,43.4,53.1
VA,"Frederick County, Virginia",5247,2162,3085,51069,69098,68896,69539,75089,69698,55353,34801,4806,36267,4491,71068,9297,"Frederick County, Virginia(6,10)",72.3,64,"Frederick County, Virginia",52.6,46,falling,83199,51,69,52.6,72.3
VA,"Giles County, Virginia",1891,851,1040,51071,46390,46840,NA,NA,50875,46705,6871,1369,7376,1158,14247,2527,"Giles County, Virginia(6,10)",66.7,16,"Giles County, Virginia",64.1,16,stable,16708,51,71,64.1,66.7
VA,"Gloucester County, Virginia",2735,1165,1570,51073,61121,61466,53108,102212,NA,83202,15163,2448,16690,1875,31853,4323,"Gloucester County, Virginia(6,10)",88.7,42,"Gloucester County, Virginia",72.2,34,stable,37143,51,73,72.2,88.7
VA,"Goochland County, Virginia",1163,520,643,51075,79330,87143,39798,NA,NA,61429,9463,565,9654,727,19117,1292,"Goochland County, Virginia(6,10)",66.3,20,"Goochland County, Virginia",44.3,13,falling,22253,51,75,44.3,66.3
VA,"Grayson County, Virginia",3244,1359,1885,51077,29942,30546,10990,NA,NA,26384,6406,1063,6899,929,13305,1992,"Grayson County, Virginia(6,10)",63.6,16,"Grayson County, Virginia",62.7,16,stable,16012,51,77,62.7,63.6
VA,"Greene County, Virginia",1853,751,1102,51079,61550,62352,42625,NA,140543,66600,7787,1368,8152,1421,15939,2789,"Greene County, Virginia(6,10)",62.5,14,"Greene County, Virginia",44,9,falling,19162,51,79,44,62.5
VA,"Greensville County, Virginia",1490,497,993,51081,38012,48517,32798,NA,NA,NA,2862,304,3991,407,6853,711,"Greensville County, Virginia(6,10)",81.5,12,"Greensville County, Virginia",53.1,8,stable,11885,51,81,53.1,81.5
VA,"Halifax County, Virginia",6675,3041,3634,51083,35240,40330,26535,NA,44800,28170,13598,2820,15992,2384,29590,5204,"Halifax County with South Boston City, Virginia(6,10)",58.7,32,"Halifax County with South Boston City, Virginia",49.6,27,stable,35125,51,83,49.6,58.7
VA,"Hanover County, Virginia",5976,2392,3584,51085,78645,81174,58191,60750,78750,70859,45981,3228,48666,2723,94647,5951,"Hanover County, Virginia(6,10)",80.7,94,"Hanover County, Virginia",53,60,falling,103227,51,85,53,80.7
VA,"Henrico County, Virginia",33914,14118,19796,51087,61934,69574,46090,55347,87371,49513,131760,17728,151314,16043,283074,33771,"Henrico County, Virginia(6,10)",57.2,190,"Henrico County, Virginia",46.2,154,falling,325155,51,87,46.2,57.2
VA,"Henry County, Virginia",9520,4167,5353,51089,35293,36789,28970,NA,NA,35923,21245,3589,23490,3644,44735,7233,"Henry County, Virginia(6,10)",69.9,56,"Henry County, Virginia",54.7,44,rising,51881,51,89,54.7,69.9
VA,"Highland County, Virginia",282,88,194,51091,43914,43816,NA,NA,NA,NA,788,215,1033,208,1821,423,"Highland County, Virginia(6,10)",*,3 or fewer,"Highland County, Virginia",*,*,**,2214,51,91,NA,NA
VA,"Isle of Wight County, Virginia",4137,1943,2194,51093,65741,72742,42596,NA,NA,101176,15400,1844,16581,1445,31981,3289,"Isle of Wight County, Virginia(6,10)",63,29,"Isle of Wight County, Virginia",47.6,22,falling,36314,51,93,47.6,63
VA,"James City County, Virginia",5648,2559,3089,51095,75710,80998,48446,NA,112273,59216,30377,2719,33417,2569,63794,5288,"James City County, Virginia(6,10)",42.8,45,"James City County, Virginia",34,37,falling,73147,51,95,34,42.8
VA,"King and Queen County, Virginia",949,470,479,51097,48292,52000,45086,NA,NA,NA,3046,620,2929,511,5975,1131,"King and Queen County, Virginia(6,10)",80.1,8,"King and Queen County, Virginia",69,7,stable,7158,51,97,69,80.1
VA,"King George County, Virginia",1366,522,844,51099,81688,82741,68406,NA,72829,185667,11106,1084,11501,817,22607,1901,"King George County, Virginia(6,10)",92.7,19,"King George County, Virginia",55.4,12,stable,25515,51,99,55.4,92.7
VA,"King William County, Virginia",1897,835,1062,51101,62031,65246,43594,65625,NA,53523,7059,784,7410,785,14469,1569,"King William County, Virginia(6,10)",60.8,11,"King William County, Virginia",48.2,9,stable,16269,51,101,48.2,60.8
VA,"Lancaster County, Virginia",1246,551,695,51103,50374,56498,37628,NA,140577,NA,4506,709,5247,581,9753,1290,"Lancaster County, Virginia(6,10)",58.5,15,"Lancaster County, Virginia",50.8,13,falling,10965,51,103,50.8,58.5
VA,"Lee County, Virginia",6027,2490,3537,51105,31086,31218,NA,NA,NA,NA,9978,1920,10177,1706,20155,3626,"Lee County, Virginia(6,10)",82.4,27,"Lee County, Virginia",85.9,28,stable,24742,51,105,85.9,82.4
VA,"Loudoun County, Virginia",14047,5850,8197,51107,123453,125761,100669,83162,136005,77596,157541,14975,163902,12866,321443,27841,"Loudoun County, Virginia(6,10)",40.8,85,"Loudoun County, Virginia",34.2,67,falling,375629,51,107,34.2,40.8
VA,"Louisa County, Virginia",3385,1584,1801,51109,57829,59712,45903,31350,103221,46613,13771,2941,14541,2635,28312,5576,"Louisa County, Virginia(6,10)",80,35,"Louisa County, Virginia",59.7,26,stable,34602,51,109,59.7,80
VA,"Lunenburg County, Virginia",2279,1015,1264,51111,39506,44361,29583,NA,NA,25313,4355,870,5104,862,9459,1732,"Lunenburg County, Virginia(6,10)",67.5,12,"Lunenburg County, Virginia",57.7,11,stable,12299,51,111,57.7,67.5
VA,"Madison County, Virginia",1613,725,888,51113,47736,48930,19531,NA,NA,91625,5113,1182,5844,832,10957,2014,"Madison County, Virginia(6,10)",81.9,15,"Madison County, Virginia",47.1,9,stable,13134,51,113,47.1,81.9
VA,"Mathews County, Virginia",613,274,339,51115,63845,65780,47875,NA,NA,NA,3671,370,4387,333,8058,703,"Mathews County, Virginia(6,10)",64.6,10,"Mathews County, Virginia",47.6,9,stable,8862,51,115,47.6,64.6
VA,"Mecklenburg County, Virginia",5975,2697,3278,51117,37356,42855,25281,NA,NA,55655,11851,2293,14112,1936,25963,4229,"Mecklenburg County, Virginia(6,10)",75.2,39,"Mecklenburg County, Virginia",63.5,33,stable,31081,51,117,63.5,75.2
VA,"Middlesex County, Virginia",982,462,520,51119,54654,60625,28438,NA,NA,NA,4455,555,4995,345,9450,900,"Middlesex County, Virginia(6,10)",79.4,16,"Middlesex County, Virginia",60.1,13,stable,10606,51,119,60.1,79.4
VA,"Montgomery County, Virginia",21707,11805,9902,51121,46663,48441,37961,50819,32569,38137,45251,4418,43141,3090,88392,7508,"Montgomery County, Virginia(6,10)",54,43,"Montgomery County, Virginia",41.7,33,stable,97653,51,121,41.7,54
VA,"Nelson County, Virginia",2159,1131,1028,51125,47118,51037,26657,NA,NA,NA,6176,1016,6693,916,12869,1932,"Nelson County, Virginia(6,10)",92,21,"Nelson County, Virginia",62.3,15,stable,14785,51,125,62.3,92
VA,"New Kent County, Virginia",1327,485,842,51127,73041,72346,75000,NA,141027,107672,8949,665,8786,620,17735,1285,"New Kent County, Virginia(6,10)",76.4,15,"New Kent County, Virginia",68.1,13,stable,20392,51,127,68.1,76.4
VA,"Northampton County, Virginia",2730,1193,1537,51131,35055,47604,18805,NA,61354,NA,4367,1341,5069,1109,9436,2450,"Northampton County, Virginia(6,10)",83.6,17,"Northampton County, Virginia",73.6,15,stable,12155,51,131,73.6,83.6
VA,"Northumberland County, Virginia",1352,537,815,51133,51885,58750,41201,NA,NA,NA,5443,494,5866,501,11309,995,"Northumberland County, Virginia(6,10)",71.6,20,"Northumberland County, Virginia",52.3,14,stable,12232,51,133,52.3,71.6
VA,"Nottoway County, Virginia",3444,1760,1684,51135,36284,44493,28375,NA,NA,35435,6074,1133,6609,673,12683,1806,"Nottoway County, Virginia(6,10)",67.6,14,"Nottoway County, Virginia",52.4,11,stable,15673,51,135,52.4,67.6
VA,"Orange County, Virginia",4105,1637,2468,51137,65166,66077,36964,NA,115938,67174,14125,2432,15708,1808,29833,4240,"Orange County, Virginia(6,10)",77.8,37,"Orange County, Virginia",54.2,26,stable,35385,51,137,54.2,77.8
VA,"Page County, Virginia",3880,1813,2067,51139,43895,44331,27969,NA,NA,33190,9798,1753,10341,1756,20139,3509,"Page County, Virginia(6,10)",66.1,22,"Page County, Virginia",59.8,20,stable,23726,51,139,59.8,66.1
VA,"Patrick County, Virginia",3818,1918,1900,51141,33982,35120,31060,NA,NA,11452,7405,1494,7873,1265,15278,2759,"Patrick County, Virginia(6,10)",51.2,15,"Patrick County, Virginia",48.3,15,stable,18045,51,141,48.3,51.2
VA,"Pittsylvania County, Virginia",9944,3897,6047,51143,41824,44450,34851,NA,59688,39417,26329,3758,28133,3766,54462,7524,"Pittsylvania County, Virginia(6,10)",59.3,54,"Pittsylvania County, Virginia",55.1,50,stable,62194,51,143,55.1,59.3
VA,"Powhatan County, Virginia",1252,476,776,51145,77896,80565,41938,NA,161063,73036,11450,1149,12004,1018,23454,2167,"Powhatan County, Virginia(6,10)",65.8,21,"Powhatan County, Virginia",51.8,16,falling,28031,51,145,51.8,65.8
VA,"Prince Edward County, Virginia",3883,1503,2380,51147,41697,49571,28152,NA,NA,NA,9331,1508,10247,1213,19578,2721,"Prince Edward County, Virginia(6,10)",53.3,13,"Prince Edward County, Virginia",45.7,11,falling,22952,51,147,45.7,53.3
VA,"Prince George County, Virginia",3370,1612,1758,51149,61857,68388,56792,50313,83000,44032,14557,1641,15041,1285,29598,2926,"Prince George County, Virginia(6,10)",65.2,24,"Prince George County, Virginia",49,17,falling,37862,51,149,49,65.2
VA,"Prince William County, Virginia",28739,12982,15757,51153,98657,104209,87787,66432,94287,70087,181415,29623,192841,25170,374256,54793,"Prince William County, Virginia(6,10)",48.4,133,"Prince William County, Virginia",40.9,107,falling,451721,51,153,40.9,48.4
VA,"Pulaski County, Virginia",4506,2063,2443,51155,47495,47041,49286,NA,NA,NA,14622,1853,15274,1840,29896,3693,"Pulaski County, Virginia(6,10)",62.8,32,"Pulaski County, Virginia",59.1,30,stable,34332,51,155,59.1,62.8
VA,"Rappahannock County, Virginia",733,323,410,51157,57210,60313,45544,NA,NA,41369,3041,626,3185,561,6226,1187,"Rappahannock County, Virginia(6,10)",65.2,7,"Rappahannock County, Virginia",41.2,5,stable,7378,51,157,41.2,65.2
VA,"Richmond County, Virginia",748,289,459,51159,47288,50584,35511,NA,NA,NA,3021,350,3382,351,6403,701,"Richmond County, Virginia(6,10)",72.9,9,"Richmond County, Virginia",44.5,6,falling,8908,51,159,44.5,72.9
VA,"Roanoke County, Virginia",7607,3482,4125,51161,60519,60643,54063,96750,82792,62031,40502,3370,45602,2595,86104,5965,"Roanoke County, Virginia(6,10)",55.2,72,"Roanoke County, Virginia",42.7,56,stable,94409,51,161,42.7,55.2
VA,"Rockbridge County, Virginia",3085,1379,1706,51163,48901,49480,NA,NA,55795,63009,9518,1452,9803,1492,19321,2944,"Rockbridge County, Virginia(6,10)",32,12,"Rockbridge County, Virginia",37.1,14,stable,22354,51,163,37.1,32
VA,"Rockingham County, Virginia",8471,3839,4632,51165,53744,53801,60694,NA,85833,34768,32610,5364,35016,4421,67626,9785,"Rockingham County, Virginia(6,10)",49.4,51,"Rockingham County, Virginia",39.2,40,stable,78593,51,165,39.2,49.4
VA,"Russell County, Virginia",5777,2322,3455,51167,35045,35181,21336,NA,NA,NA,11370,2263,12398,1988,23768,4251,"Russell County, Virginia(6,10)",63.5,25,"Russell County, Virginia",65.4,26,stable,27891,51,167,65.4,63.5
VA,"Scott County, Virginia",4406,1945,2461,51169,37240,37228,NA,NA,100208,NA,9408,1489,9941,1111,19349,2600,"Scott County, Virginia(6,10)",72.1,25,"Scott County, Virginia",67.2,24,stable,22126,51,169,67.2,72.1
VA,"Shenandoah County, Virginia",5138,2009,3129,51171,49406,49618,47917,140000,NA,36489,17819,2682,19126,2645,36945,5327,"Shenandoah County, Virginia(6,10)",67.4,41,"Shenandoah County, Virginia",54.3,33,stable,43190,51,171,54.3,67.4
VA,"Smyth County, Virginia",5815,2757,3058,51173,37983,38430,NA,NA,NA,42500,12935,2252,14219,1792,27154,4044,"Smyth County, Virginia(6,10)",92,42,"Smyth County, Virginia",79.5,36,stable,31470,51,173,79.5,92
VA,"Southampton County, Virginia",2649,1175,1474,51175,48962,63717,31972,97679,NA,18462,7002,1249,7511,1110,14513,2359,"Southampton County, Virginia(6,10)",63.8,16,"Southampton County, Virginia",47.6,12,falling,18109,51,175,47.6,63.8
VA,"Spotsylvania County, Virginia",10396,4565,5831,51177,78125,81628,68838,112574,79886,64973,54453,7609,58090,6628,112543,14237,"Spotsylvania County, Virginia(6,10)",68.2,77,"Spotsylvania County, Virginia",52.9,57,falling,130475,51,177,52.9,68.2
VA,"Stafford County, Virginia",6948,2928,4020,51179,97144,98129,108560,95000,69286,73553,57845,6038,62285,4940,120130,10978,"Stafford County, Virginia(6,10)",77.4,72,"Stafford County, Virginia",53,46,stable,142003,51,179,53,77.4
VA,"Surry County, Virginia",881,403,478,51181,53673,60852,43696,NA,NA,NA,2798,551,3020,454,5818,1005,"Surry County, Virginia(6,10)",60.9,6,"Surry County, Virginia",53.7,5,stable,6709,51,181,53.7,60.9
VA,"Sussex County, Virginia",1362,439,923,51183,39194,51500,30137,NA,NA,NA,2766,202,3316,342,6082,544,"Sussex County, Virginia(6,10)",90.7,14,"Sussex County, Virginia",69.2,10,falling,11715,51,183,69.2,90.7
VA,"Tazewell County, Virginia",7518,3186,4332,51185,37664,38035,15133,NA,NA,NA,17568,3180,19194,2758,36762,5938,"Tazewell County, Virginia(6,10)",67.6,42,"Tazewell County, Virginia",64.5,40,stable,42899,51,185,64.5,67.6
VA,"Warren County, Virginia",3696,1533,2163,51187,61454,62236,47277,39712,47639,40682,16779,2310,16876,2147,33655,4457,"Warren County, Virginia(6,10)",72.1,31,"Warren County, Virginia",56.7,24,stable,39083,51,187,56.7,72.1
VA,"Washington County, Virginia",6845,3161,3684,51191,43310,43426,34301,NA,NA,24449,23508,3123,24471,3018,47979,6141,"Washington County, Virginia(6,10)",75.6,60,"Washington County, Virginia",61.9,49,stable,54591,51,191,61.9,75.6
VA,"Westmoreland County, Virginia",2323,1045,1278,51193,47911,50899,36763,NA,NA,NA,6984,1480,7735,1204,14719,2684,"Westmoreland County, Virginia(6,10)",74.7,22,"Westmoreland County, Virginia",52.3,15,falling,17629,51,193,52.3,74.7
VA,"Wise County, Virginia",8414,3646,4768,51195,37407,37889,10298,NA,NA,22692,16419,2526,17017,2358,33436,4884,"Wise County, Virginia(6,10)",84.3,42,"Wise County, Virginia",75,36,stable,39718,51,195,75,84.3
VA,"Wythe County, Virginia",4356,2050,2306,51197,41360,41460,34583,NA,36500,36250,12470,1769,12508,2170,24978,3939,"Wythe County, Virginia(6,10)",74.7,31,"Wythe County, Virginia",48.2,21,falling,29119,51,197,48.2,74.7
VA,"York County, Virginia",4198,1815,2383,51199,81749,86583,62089,NA,84881,67344,28042,2094,31490,1852,59532,3946,"York County, Virginia(6,10)",48.4,33,"York County, Virginia",37,25,falling,67837,51,199,37,48.4
VA,"Alexandria city, Virginia",12359,4903,7456,51510,89134,105774,54350,NA,96705,61162,58340,11458,66921,9509,125261,20967,"Alexandria City, Virginia(6,10)",28.8,34,"Alexandria City, Virginia",26.4,33,falling,153511,51,510,26.4,28.8
VA,"Bristol city, Virginia",3496,1410,2086,51520,35368,36418,21900,NA,NA,NA,6543,1492,8273,1059,14816,2551,"Bristol City, Virginia(6,10)",54.6,14,"Bristol City, Virginia",76.6,20,stable,17141,51,520,76.6,54.6
VA,"Buena Vista city, Virginia",1755,529,1226,51530,29097,27253,NA,NA,NA,NA,2489,551,2995,555,5484,1106,"Buena Vista City, Virginia(6,10)",107.3,8,"Buena Vista City, Virginia",84.3,6,stable,6618,51,530,84.3,107.3
VA,"Charlottesville city, Virginia",10995,5182,5813,51540,49775,56756,32816,NA,41020,58450,19142,2389,20847,2328,39989,4717,"Charlottesville City, Virginia(6,10)",114.7,38,"Charlottesville City, Virginia",55.1,19,stable,46597,51,540,55.1,114.7
VA,"Chesapeake city, Virginia",21734,8627,13107,51550,68620,77034,52592,49571,89239,65635,92540,9502,106793,9602,199333,19104,"Chesapeake City, Virginia(6,10)",71.6,149,"Chesapeake City, Virginia",51.8,105,falling,235429,51,550,51.8,71.6
VA,"Colonial Heights city, Virginia",1974,837,1137,51570,50304,53425,40829,120714,40000,47261,7065,947,8246,1010,15311,1957,"Colonial Heights City, Virginia(6,10)",69.5,17,"Colonial Heights City, Virginia",47.2,12,falling,17820,51,570,47.2,69.5
VA,"Covington city, Virginia",1437,587,850,51580,34746,37426,32598,NA,NA,NA,2384,431,2323,418,4707,849,"Covington City, Virginia(6,10)",167,13,"Covington City, Virginia",66.2,5,stable,5658,51,580,66.2,167
VA,"Danville city, Virginia",9629,4000,5629,51590,32315,39110,27783,20833,49417,40625,16255,2690,19869,2495,36124,5185,"Danville City, Virginia(6,10)",92.4,57,"Danville City, Virginia",56,35,stable,42082,51,590,56,92.4
VA,"Emporia city, Virginia",1907,862,1045,51595,28601,46000,22511,NA,NA,NA,1825,684,2492,456,4317,1140,"Emporia City, Virginia(6,10)",56.2,4,"Emporia City, Virginia",64.3,5,stable,5496,51,595,64.3,56.2
VA,"Fairfax city, Virginia",1593,831,762,51600,105297,111375,102130,NA,114667,81385,9803,1455,10508,1132,20311,2587,"Fairfax City, Virginia(6,10)",26.5,7,"Fairfax City, Virginia",40.3,11,falling,24013,51,600,40.3,26.5
VA,"Falls Church city, Virginia",361,124,237,51610,120522,136311,85962,NA,72134,81607,6120,166,6616,309,12736,475,"Falls Church City, Virginia(6,10)",44.8,5,"Falls Church City, Virginia",25.1,3,falling,13892,51,610,25.1,44.8
VA,"Franklin city, Virginia",1762,962,800,51620,32399,51164,29211,NA,NA,19324,3109,605,3958,655,7067,1260,"Franklin City, Virginia(6,10)",82.8,9,"Franklin City, Virginia",47.6,5,stable,8490,51,620,47.6,82.8
VA,"Fredericksburg city, Virginia",4108,1727,2381,51630,51762,58952,38750,NA,105125,34522,10932,1700,12554,1962,23486,3662,"Fredericksburg City, Virginia(6,10)",95.1,20,"Fredericksburg City, Virginia",49.1,11,falling,28118,51,630,49.1,95.1
VA,"Galax city, Virginia",1766,913,853,51640,30604,30594,31389,NA,NA,50556,2680,540,2962,404,5642,944,"Galax City, Virginia(6,10)",80.2,8,"Galax City, Virginia",36.8,4,stable,6914,51,640,36.8,80.2
VA,"Hampton city, Virginia",20187,8590,11597,51650,49190,57353,40539,NA,48542,55417,53054,8905,62299,7512,115353,16417,"Hampton City, Virginia(6,10)",76.8,110,"Hampton City, Virginia",56,80,falling,136454,51,650,56,76.8
VA,"Harrisonburg city, Virginia",14326,6628,7698,51660,38750,39018,32670,NA,40455,37392,20221,3794,22806,3851,43027,7645,"Harrisonburg City, Virginia(6,10)",91.2,29,"Harrisonburg City, Virginia",48.2,16,stable,52538,51,660,48.2,91.2
VA,"Hopewell city, Virginia",4165,1792,2373,51670,39064,40483,32881,NA,NA,62716,8816,1592,10088,1452,18904,3044,"Hopewell City, Virginia(6,10)",89.5,24,"Hopewell City, Virginia",66.6,18,stable,22378,51,670,66.6,89.5
VA,"Lexington city, Virginia",678,205,473,51678,34017,31136,34857,NA,45804,39911,2913,214,2361,155,5274,369,"Lexington City, Virginia(6,10)",110.1,7,"Lexington City, Virginia",*,*,*,7262,51,678,NA,110.1
VA,"Lynchburg city, Virginia",16775,7243,9532,51680,39589,47725,25422,NA,64167,41019,31269,4648,36055,4663,67324,9311,"Lynchburg City, Virginia(6,10)",75.9,61,"Lynchburg City, Virginia",52.8,44,falling,79812,51,680,52.8,75.9
VA,"Manassas city, Virginia",3945,1572,2373,51683,72890,75170,68750,NA,51522,59392,16098,4164,16731,3696,32829,7860,"Manassas City, Virginia(6,10)",55.1,14,"Manassas City, Virginia",38.8,10,stable,41764,51,683,38.8,55.1
VA,"Manassas Park city, Virginia",1232,646,586,51685,73528,69982,NA,NA,92019,61046,5839,2304,5675,1721,11514,4025,"Manassas Park City, Virginia(6,10)",*,3 or fewer,"Manassas Park City, Virginia",42,4,stable,15726,51,685,42,NA
VA,"Martinsville city, Virginia",3105,1269,1836,51690,29587,32465,24203,NA,NA,55313,4866,1064,6285,1056,11151,2120,"Martinsville City, Virginia(6,10)",70.8,14,"Martinsville City, Virginia",81.9,17,rising,13645,51,690,81.9,70.8
VA,"Newport News city, Virginia",26984,11787,15197,51700,50077,59736,39785,57808,50571,43819,68381,12028,81163,10640,149544,22668,"Newport News City, Virginia(6,10)",75.2,125,"Newport News City, Virginia",57.3,94,falling,182385,51,700,57.3,75.2
VA,"Norfolk city, Virginia",46288,21633,24655,51710,44480,56559,31925,38750,54193,40487,87440,19429,96562,15844,184002,35273,"Norfolk City, Virginia(6,10)",75.6,152,"Norfolk City, Virginia",53.6,108,falling,246393,51,710,53.6,75.6
VA,"Norton city, Virginia",949,369,580,51720,27731,27031,36393,NA,NA,NA,1367,234,2155,193,3522,427,"Norton City, Virginia(6,10)",100.5,5,"Norton City, Virginia",*,*,**,3939,51,720,NA,100.5
VA,"Petersburg city, Virginia",8795,3584,5211,51730,31798,41766,29770,NA,NA,32008,11320,2846,14554,2519,25874,5365,"Petersburg City, Virginia(6,10)",113.1,45,"Petersburg City, Virginia",68.9,27,falling,32477,51,730,68.9,113.1
VA,"Poquoson city, Virginia",502,134,368,51735,83735,83766,140375,NA,59917,91250,5482,338,5865,252,11347,590,"Poquoson City, Virginia(6,10)",50.2,7,"Poquoson City, Virginia",44.2,7,falling,12059,51,735,44.2,50.2
VA,"Portsmouth city, Virginia",17000,6563,10437,51740,45676,54553,36833,38162,42188,37016,37167,6080,42515,6536,79682,12616,"Portsmouth City, Virginia(6,10)",78.3,81,"Portsmouth City, Virginia",60.3,63,falling,96201,51,740,60.3,78.3
VA,"Radford city, Virginia",5497,2608,2889,51750,29912,31834,19489,NA,NA,23750,7317,805,8094,670,15411,1475,"Radford City, Virginia(6,10)",87.3,9,"Radford City, Virginia",67.2,7,stable,17403,51,750,67.2,87.3
VA,"Richmond city, Virginia",51828,22792,29036,51760,40758,57279,28230,24509,45932,32486,79997,19858,95434,15861,175431,35719,"Richmond City, Virginia(6,10)",76.1,151,"Richmond City, Virginia",57.3,115,falling,220289,51,760,57.3,76.1
VA,"Roanoke city, Virginia",20514,8945,11569,51770,39930,43256,29855,NA,34153,29071,38410,8301,43908,6823,82318,15124,"Roanoke City, Virginia(6,10)",95.5,110,"Roanoke City, Virginia",65.3,75,stable,99897,51,770,65.3,95.5
VA,"Salem city, Virginia",2578,1082,1496,51775,50068,51080,27500,NA,40278,NA,10218,1258,11713,1306,21931,2564,"Salem City, Virginia(6,10)",71.5,24,"Salem City, Virginia",51,17,stable,25432,51,775,51,71.5
VA,"Staunton city, Virginia",4052,1677,2375,51790,40842,41319,34565,NA,38320,61719,9175,1415,11390,1665,20565,3080,"Staunton City, Virginia(6,10)",96.8,35,"Staunton City, Virginia",54.3,20,stable,24416,51,790,54.3,96.8
VA,"Suffolk city, Virginia",9835,4190,5645,51800,65499,78573,46878,82727,70966,65259,35051,4543,40616,3608,75667,8151,"Suffolk City, Virginia(6,10)",68.3,59,"Suffolk City, Virginia",48.2,41,falling,88161,51,800,48.2,68.3
VA,"Virginia Beach city, Virginia",36267,15055,21212,51810,66634,71156,51265,69201,72597,54825,177592,22265,203264,19818,380856,42083,"Virginia Beach City, Virginia(6,10)",67.5,279,"Virginia Beach City, Virginia",46.8,191,falling,452745,51,810,46.8,67.5
VA,"Waynesboro city, Virginia",3796,1496,2300,51820,45643,47439,26978,NA,59327,26897,8151,1881,9559,1418,17710,3299,"Waynesboro City, Virginia(6,10)",88.3,24,"Waynesboro City, Virginia",50.9,14,stable,21491,51,820,50.9,88.3
VA,"Williamsburg city, Virginia",2401,1108,1293,51830,48639,53378,33378,NA,2499,45329,5859,694,7727,292,13586,986,"Williamsburg City, Virginia(6,10)",127.9,19,"Williamsburg City, Virginia",28.7,4,falling,15052,51,830,28.7,127.9
VA,"Winchester city, Virginia",4200,1784,2416,51840,45363,48133,40696,NA,41588,30885,10765,2501,11474,2166,22239,4667,"Winchester City, Virginia(6,10)",57.1,17,"Winchester City, Virginia",51.9,16,stable,27284,51,840,51.9,57.1
VT,"Addison County, Vermont",3124,1498,1626,50001,59688,59734,NA,NA,63750,63355,16935,1355,17583,841,34518,2196,"Addison County, Vermont(6,10)",65.6,30,"Addison County, Vermont",45.6,20,stable,37035,50,1,45.6,65.6
VT,"Bennington County, Vermont",4735,2226,2509,50003,49573,49907,55613,NA,118382,131852,16484,1227,17710,683,34194,1910,"Bennington County, Vermont(6,10)",64.3,36,"Bennington County, Vermont",46,26,stable,36317,50,3,46,64.3
VT,"Caledonia County, Vermont",3733,1458,2275,50005,45323,45475,NA,NA,41250,36042,13745,1374,14869,633,28614,2007,"Caledonia County, Vermont(6,10)",74.8,29,"Caledonia County, Vermont",57.2,23,stable,30780,50,5,57.2,74.8
VT,"Chittenden County, Vermont",17045,7513,9532,50007,65350,66990,40873,31406,52023,54875,73192,4265,78128,2958,151320,7223,"Chittenden County, Vermont(6,10)",65.5,104,"Chittenden County, Vermont",42.8,67,falling,161382,50,7,42.8,65.5
VT,"Essex County, Vermont",929,412,517,50009,36599,36895,NA,9375,60893,28125,2775,336,2882,214,5657,550,"Essex County, Vermont(6,10)",77.6,8,"Essex County, Vermont",48.7,5,**,6163,50,9,48.7,77.6
VT,"Franklin County, Vermont",4147,1893,2254,50011,58199,58139,NA,70259,45441,82757,21866,1751,23348,910,45214,2661,"Franklin County, Vermont(6,10)",79.6,41,"Franklin County, Vermont",59,29,stable,48799,50,11,59,79.6
VT,"Grand Isle County, Vermont",598,275,323,50013,62608,63168,NA,NA,NA,41250,3238,181,3398,135,6636,316,"Grand Isle County, Vermont(6,10)",89.1,7,"Grand Isle County, Vermont",44.6,4,stable,6861,50,13,44.6,89.1
VT,"Lamoille County, Vermont",2887,1126,1761,50015,50939,50715,NA,78813,NA,75809,11169,1231,11606,926,22775,2157,"Lamoille County, Vermont(6,10)",66.1,19,"Lamoille County, Vermont",43.9,13,stable,25235,50,15,43.9,66.1
VT,"Orange County, Vermont",3498,1601,1897,50017,53869,54159,73958,45357,49167,32115,13236,1091,13853,662,27089,1753,"Orange County, Vermont(6,10)",67.2,24,"Orange County, Vermont",56.9,21,stable,28899,50,17,56.9,67.2
VT,"Orleans County, Vermont",4070,1866,2204,50019,42831,43095,NA,25455,NA,56250,11937,1229,12539,798,24476,2027,"Orleans County, Vermont(6,10)",59.4,23,"Orleans County, Vermont",48.5,19,stable,27100,50,19,48.5,59.4
VT,"Rutland County, Vermont",7276,3507,3769,50021,49372,49478,170195,NA,51111,44464,27003,2340,29043,1462,56046,3802,"Rutland County, Vermont(6,10)",72.6,63,"Rutland County, Vermont",51.3,44,stable,59736,50,21,51.3,72.6
VT,"Washington County, Vermont",5729,2530,3199,50023,58788,58636,85074,87642,83156,44716,27153,1838,28500,1139,55653,2977,"Washington County, Vermont(6,10)",61,46,"Washington County, Vermont",47.6,36,falling,58612,50,23,47.6,61
VT,"Windham County, Vermont",5421,2361,3060,50025,51045,51544,55508,45781,48500,30938,19827,1631,20905,1054,40732,2685,"Windham County, Vermont(6,10)",58.9,36,"Windham County, Vermont",41.8,25,falling,43386,50,25,41.8,58.9
VT,"Windsor County, Vermont",6041,2725,3316,50027,52965,53036,89922,NA,57500,33906,24618,2209,26757,1685,51375,3894,"Windsor County, Vermont(6,10)",67.4,57,"Windsor County, Vermont",45.7,39,stable,55737,50,27,45.7,67.4
WA,"Adams County, Washington",4019,1948,2071,53001,46564,52046,NA,NA,NA,40060,7244,2345,7393,1866,14637,4211,"Adams County, Washington(6,10)",37,6,"Adams County, Washington",29.9,5,falling,19254,53,1,29.9,37
WA,"Asotin County, Washington",3301,1474,1827,53003,44394,44467,NA,NA,101583,31250,9147,1338,10096,1276,19243,2614,"Asotin County, Washington(6,10)",66.8,21,"Asotin County, Washington",51.2,17,stable,22105,53,3,51.2,66.8
WA,"Benton County, Washington",26013,11805,14208,53005,60251,62873,48844,45066,70875,39209,78627,12759,81892,10110,160519,22869,"Benton County, Washington(6,10)",59.9,109,"Benton County, Washington",44.8,81,falling,190309,53,5,44.8,59.9
WA,"Chelan County, Washington",10466,4799,5667,53007,51837,52185,40357,48194,NA,41889,30164,6518,31017,5995,61181,12513,"Chelan County, Washington(6,10)",49.8,47,"Chelan County, Washington",38.3,36,falling,75644,53,7,38.3,49.8
WA,"Clallam County, Washington",10682,4864,5818,53009,47253,48246,NA,31926,38482,38636,30189,5059,32350,3823,62539,8882,"Clallam County, Washington(7,8)",69.6,90,"Clallam County, Washington",51.2,66,stable,73486,53,9,51.2,69.6
WA,"Clark County, Washington",49314,21861,27453,53011,60756,61954,42788,50500,70577,41362,191398,26615,202078,21962,393476,48577,"Clark County, Washington(6,10)",62.1,266,"Clark County, Washington",48,206,falling,459495,53,11,48,62.1
WA,"Columbia County, Washington",690,357,333,53013,38581,39696,NA,26667,NA,NA,1801,152,1772,204,3573,356,"Columbia County, Washington(6,10)",62.2,4,"Columbia County, Washington",48.6,4,**,3944,53,13,48.6,62.2
WA,"Cowlitz County, Washington",17609,8049,9560,53015,47452,48750,31250,30784,40417,31954,43804,6096,46637,4793,90441,10889,"Cowlitz County, Washington(6,10)",66.3,88,"Cowlitz County, Washington",53.9,71,stable,103468,53,15,53.9,66.3
WA,"Douglas County, Washington",5835,2677,3158,53017,53636,57899,NA,66806,NA,39799,16380,3439,16466,3183,32846,6622,"Douglas County, Washington(6,10)",42,19,"Douglas County, Washington",38.6,17,stable,40534,53,17,38.6,42
WA,"Ferry County, Washington",1659,906,753,53019,38125,40235,NA,23125,NA,NA,3358,584,3156,482,6514,1066,"Ferry County, Washington(6,10)",46,6,"Ferry County, Washington",37.8,4,stable,7582,53,19,37.8,46
WA,"Franklin County, Washington",15406,7067,8339,53021,56980,61241,NA,NA,58658,41444,34404,8573,33744,7554,68148,16127,"Franklin County, Washington(6,10)",52.7,27,"Franklin County, Washington",38.5,19,falling,88807,53,21,38.5,52.7
WA,"Garfield County, Washington",252,95,157,53023,45855,46912,NA,NA,NA,NA,978,125,988,111,1966,236,"Garfield County, Washington(6,10)",*,3 or fewer,"Garfield County, Washington",*,*,**,2219,53,23,NA,NA
WA,"Grant County, Washington",16295,7498,8797,53025,48714,51561,NA,40938,NA,40238,36748,9464,37816,7528,74564,16992,"Grant County, Washington(6,10)",57.1,49,"Grant County, Washington",44.5,39,falling,93259,53,25,44.5,57.1
WA,"Grays Harbor County, Washington",12357,5580,6777,53027,43538,43743,NA,35900,65697,34025,28006,6113,29766,4657,57772,10770,"Grays Harbor County, Washington(7,8)",81.9,81,"Grays Harbor County, Washington",62.6,61,falling,71122,53,27,62.6,81.9
WA,"Island County, Washington",7430,3115,4315,53029,58815,60077,47891,58147,50933,41924,32026,3558,35824,2956,67850,6514,"Island County, Washington(7,8)",48.2,56,"Island County, Washington",32.4,38,falling,80593,53,29,32.4,48.2
WA,"Jefferson County, Washington",3508,1500,2008,53031,49279,49657,NA,38690,44848,32208,12750,1462,13636,1516,26386,2978,"Jefferson County, Washington(7,8)",55.7,34,"Jefferson County, Washington",43.5,27,stable,30466,53,31,43.5,55.7
WA,"King County, Washington",226204,105541,120663,53033,75302,80107,38696,41741,82928,50430,902948,109785,931439,87970,1834387,197755,"King County, Washington(7,8)",51.8,972,"King County, Washington",36.4,681,falling,2117125,53,33,36.4,51.8
WA,"Kitsap County, Washington",26349,11851,14498,53035,62941,64380,40053,42237,67014,55778,105860,12172,114564,9019,220424,21191,"Kitsap County, Washington(7,8)",60.5,173,"Kitsap County, Washington",43,123,falling,260131,53,35,43,60.5
WA,"Kittitas County, Washington",8804,3868,4936,53037,46458,47942,43314,NA,21990,40500,18041,2888,18507,2461,36548,5349,"Kittitas County, Washington(6,10)",47.4,20,"Kittitas County, Washington",44.4,18,falling,43269,53,37,44.4,47.4
WA,"Klickitat County, Washington",3150,1141,2009,53039,48319,48435,NA,47438,NA,54900,8931,1312,9304,1230,18235,2542,"Klickitat County, Washington(6,10)",47.6,15,"Klickitat County, Washington",45.1,14,falling,21026,53,39,45.1,47.6
WA,"Lewis County, Washington",12126,5448,6678,53041,44100,44557,38457,38958,56979,39520,31708,5503,33362,4101,65070,9604,"Lewis County, Washington(6,10)",61.9,65,"Lewis County, Washington",52.8,56,falling,75882,53,41,52.8,61.9
WA,"Lincoln County, Washington",1562,720,842,53043,46069,46188,NA,45987,45909,NA,4580,558,4572,524,9152,1082,"Lincoln County, Washington(6,10)",60.9,10,"Lincoln County, Washington",49.6,9,stable,10321,53,43,49.6,60.9
WA,"Mason County, Washington",10166,5632,4534,53045,50406,51429,NA,46393,62250,26328,24762,5776,25128,3666,49890,9442,"Mason County, Washington(7,8)",75.9,69,"Mason County, Washington",54.2,48,falling,61023,53,45,54.2,75.9
WA,"Okanogan County, Washington",8646,4399,4247,53047,40730,43239,24635,31044,63333,32157,16363,4244,17129,3081,33492,7325,"Okanogan County, Washington(6,10)",62.8,36,"Okanogan County, Washington",47.1,26,falling,41516,53,47,47.1,62.8
WA,"Pacific County, Washington",3918,1788,2130,53049,37684,38842,NA,21958,23563,35750,8472,1709,8944,1273,17416,2982,"Pacific County, Washington(6,10)",62,24,"Pacific County, Washington",55.9,22,stable,20848,53,49,55.9,62
WA,"Pend Oreille County, Washington",2753,1293,1460,53051,40599,39945,NA,45000,NA,23816,5656,956,5504,741,11160,1697,"Pend Oreille County, Washington(6,10)",74.9,15,"Pend Oreille County, Washington",60.6,12,falling,13088,53,51,60.6,74.9
WA,"Pierce County, Washington",102233,45865,56368,53053,59953,62352,47194,44592,55991,45844,342382,49080,366397,41647,708779,90727,"Pierce County, Washington(7,8)",76.1,590,"Pierce County, Washington",51.6,396,falling,843954,53,53,51.6,76.1
WA,"San Juan County, Washington",1823,731,1092,53055,55960,57025,100962,45625,26923,31172,6533,1092,7315,961,13848,2053,"San Juan County, Washington(7,8)",34.8,11,"San Juan County, Washington",23.9,7,stable,16252,53,55,23.9,34.8
WA,"Skagit County, Washington",18815,8499,10316,53057,54129,56057,51861,39803,46250,37865,49647,8556,52627,7262,102274,15818,"Skagit County, Washington(7,8)",63.1,98,"Skagit County, Washington",47.1,74,falling,121846,53,57,47.1,63.1
WA,"Skamania County, Washington",1526,627,899,53059,52374,53480,NA,53750,52917,51944,5000,634,4888,683,9888,1317,"Skamania County, Washington(6,10)",47.7,7,"Skamania County, Washington",43.8,6,stable,11339,53,59,43.8,47.7
WA,"Snohomish County, Washington",74826,33579,41247,53061,70722,71401,55127,55880,80146,53037,324114,43247,333818,35930,657932,79177,"Snohomish County, Washington(7,8)",64.1,433,"Snohomish County, Washington",45,300,falling,772501,53,61,45,64.1
WA,"Spokane County, Washington",74110,35552,38558,53063,50079,51281,30725,27581,41528,42766,203353,27783,218074,22614,421427,50397,"Spokane County, Washington(6,10)",59.8,313,"Spokane County, Washington",47.2,245,falling,490945,53,63,47.2,59.8
WA,"Stevens County, Washington",7753,3573,4180,53065,41978,43203,NA,28681,22115,24444,18707,3059,18919,2601,37626,5660,"Stevens County, Washington(6,10)",58.7,38,"Stevens County, Washington",42.7,27,stable,43791,53,65,42.7,58.7
WA,"Thurston County, Washington",32101,14506,17595,53067,61677,61946,65460,43558,69018,54667,109470,14498,121226,11366,230696,25864,"Thurston County, Washington(7,8)",63.8,180,"Thurston County, Washington",48.1,135,falling,269536,53,67,48.1,63.8
WA,"Wahkiakum County, Washington",674,298,376,53069,44485,43897,NA,120500,NA,NA,1685,234,1875,179,3560,413,"Wahkiakum County, Washington(6,10)",55.4,4,"Wahkiakum County, Washington",*,*,**,4042,53,69,NA,55.4
WA,"Walla Walla County, Washington",9535,4153,5382,53071,47946,47903,NA,NA,89722,47233,23430,3994,25935,3006,49365,7000,"Walla Walla County, Washington(6,10)",53.4,37,"Walla Walla County, Washington",41.6,30,stable,60338,53,71,41.6,53.4
WA,"Whatcom County, Washington",32328,14556,17772,53073,53145,54744,24464,31655,58662,40514,88692,12829,92693,11182,181385,24011,"Whatcom County, Washington(7,8)",59.8,133,"Whatcom County, Washington",42.2,95,falling,212284,53,73,42.2,59.8
WA,"Whitman County, Washington",12580,6698,5882,53075,36631,39373,33750,24063,25398,18287,21484,2147,21226,1645,42710,3792,"Whitman County, Washington(6,10)",41.7,15,"Whitman County, Washington",31.7,11,stable,48177,53,75,31.7,41.7
WA,"Yakima County, Washington",51694,23973,27721,53077,44749,46845,24773,42934,50565,37141,94384,27518,100082,22537,194466,50055,"Yakima County, Washington(6,10)",57.6,137,"Yakima County, Washington",47.2,113,falling,248830,53,77,47.2,57.6
WI,"Adams County, Wisconsin",2704,1437,1267,55001,43640,43713,NA,NA,NA,25952,8852,1047,8731,623,17583,1670,"Adams County, Wisconsin(6,10)",85.7,32,"Adams County, Wisconsin",72.7,27,stable,20148,55,1,72.7,85.7
WI,"Ashland County, Wisconsin",2398,1017,1381,55003,39381,40877,NA,23523,NA,NA,7023,857,7210,668,14233,1525,"Ashland County, Wisconsin(6,10)",71.4,15,"Ashland County, Wisconsin",64.2,13,stable,15843,55,3,64.2,71.4
WI,"Barron County, Wisconsin",5640,2618,3022,55005,45714,45619,74029,28438,NA,53529,20513,2246,20742,1595,41255,3841,"Barron County, Wisconsin(6,10)",58.9,38,"Barron County, Wisconsin",47.1,31,stable,45563,55,5,47.1,58.9
WI,"Bayfield County, Wisconsin",1719,772,947,55007,46665,47444,NA,40724,34722,58750,6840,806,6659,621,13499,1427,"Bayfield County, Wisconsin(6,10)",54.9,14,"Bayfield County, Wisconsin",48.6,12,stable,14977,55,7,48.6,54.9
WI,"Brown County, Wisconsin",28969,12381,16588,55009,53527,55653,24574,39028,57246,40367,112051,11974,118922,8628,230973,20602,"Brown County, Wisconsin(6,10)",57.9,149,"Brown County, Wisconsin",41.6,107,stable,258718,55,9,41.6,57.9
WI,"Buffalo County, Wisconsin",1500,716,784,55011,50196,50007,NA,2499,NA,52500,6087,610,6131,404,12218,1014,"Buffalo County, Wisconsin(6,10)",52.4,10,"Buffalo County, Wisconsin",52.6,10,stable,13192,55,11,52.6,52.4
WI,"Burnett County, Wisconsin",2371,1171,1200,55013,41135,42180,NA,16935,34500,33125,7002,752,6922,526,13924,1278,"Burnett County, Wisconsin(6,10)",75.7,20,"Burnett County, Wisconsin",63.1,17,stable,15159,55,13,63.1,75.7
WI,"Calumet County, Wisconsin",3434,1377,2057,55015,67427,67530,NA,93393,67115,32057,23675,1135,23917,764,47592,1899,"Calumet County, Wisconsin(6,10)",53.3,27,"Calumet County, Wisconsin",37.3,18,stable,49762,55,15,37.3,53.3
WI,"Chippewa County, Wisconsin",6081,2915,3166,55017,52109,52195,NA,NA,44830,28523,27969,2835,28154,2015,56123,4850,"Chippewa County, Wisconsin(6,10)",65.8,50,"Chippewa County, Wisconsin",48.3,37,stable,63531,55,17,48.3,65.8
WI,"Clark County, Wisconsin",5504,2419,3085,55019,45048,45082,NA,37083,NA,38036,12917,4257,13163,3681,26080,7938,"Clark County, Wisconsin(6,10)",52.3,22,"Clark County, Wisconsin",33.5,14,stable,34445,55,19,33.5,52.3
WI,"Columbia County, Wisconsin",4844,2124,2720,55021,59769,60082,19563,53750,81809,49583,25586,2066,25850,1724,51436,3790,"Columbia County, Wisconsin(6,10)",64.3,45,"Columbia County, Wisconsin",45.7,32,stable,56743,55,21,45.7,64.3
WI,"Crawford County, Wisconsin",2023,869,1154,55023,44459,44459,NA,33281,NA,33750,7223,724,7359,512,14582,1236,"Crawford County, Wisconsin(6,10)",62.4,16,"Crawford County, Wisconsin",45.8,12,stable,16391,55,23,45.8,62.4
WI,"Dane County, Wisconsin",64062,28989,35073,55025,62865,66303,28106,43699,55570,37257,233187,17151,242391,13428,475578,30579,"Dane County, Wisconsin(6,10)",54.3,245,"Dane County, Wisconsin",38.8,174,falling,523643,55,25,38.8,54.3
WI,"Dodge County, Wisconsin",7658,3436,4222,55027,53783,53898,60968,53750,35227,43393,39787,2809,39114,2204,78901,5013,"Dodge County, Wisconsin(6,10)",58.6,65,"Dodge County, Wisconsin",45.6,51,stable,88502,55,27,45.6,58.6
WI,"Door County, Wisconsin",2766,1255,1511,55029,51928,52221,12574,78167,NA,36071,12515,989,13126,792,25641,1781,"Door County, Wisconsin(6,10)",53.8,27,"Door County, Wisconsin",41.2,21,stable,27554,55,29,41.2,53.8
WI,"Douglas County, Wisconsin",6713,3156,3557,55031,47095,47448,32045,38447,NA,NA,19364,2166,19725,1950,39089,4116,"Douglas County, Wisconsin(6,10)",58.1,31,"Douglas County, Wisconsin",57.9,31,stable,43601,55,31,57.9,58.1
WI,"Dunn County, Wisconsin",6140,2632,3508,55033,49788,50069,NA,41848,40982,NA,20042,2083,20090,1603,40132,3686,"Dunn County, Wisconsin(6,10)",45.4,21,"Dunn County, Wisconsin",34.5,16,stable,44497,55,33,34.5,45.4
WI,"Eau Claire County, Wisconsin",14862,6739,8123,55035,49513,50181,14900,NA,33693,NA,44541,4833,47417,3798,91958,8631,"Eau Claire County, Wisconsin(6,10)",57.1,61,"Eau Claire County, Wisconsin",43.1,46,stable,102105,55,35,43.1,57.1
WI,"Florence County, Wisconsin",409,160,249,55037,48643,48750,NA,37000,NA,61346,2117,212,1921,168,4038,380,"Florence County, Wisconsin(6,10)",66.5,5,"Florence County, Wisconsin",51.4,4,**,4464,55,37,51.4,66.5
WI,"Fond du Lac County, Wisconsin",9071,3932,5139,55039,55473,56085,NA,99509,76429,45074,45814,3550,47977,2919,93791,6469,"Fond du Lac County, Wisconsin(6,10)",60.7,76,"Fond du Lac County, Wisconsin",41.8,53,stable,101973,55,39,41.8,60.7
WI,"Forest County, Wisconsin",1505,729,776,55041,40636,40934,61667,39000,NA,21667,3838,706,3760,647,7598,1353,"Forest County, Wisconsin(6,10)",94.7,14,"Forest County, Wisconsin",48.8,7,stable,9057,55,41,48.8,94.7
WI,"Grant County, Wisconsin",7318,3707,3611,55043,49067,49133,NA,NA,NA,48542,23530,2547,22298,2000,45828,4547,"Grant County, Wisconsin(6,10)",51.5,33,"Grant County, Wisconsin",39.7,26,stable,52250,55,43,39.7,51.5
WI,"Green County, Wisconsin",3253,1413,1840,55045,56219,56748,14688,NA,NA,34940,16939,1262,17476,1020,34415,2282,"Green County, Wisconsin(6,10)",58.6,27,"Green County, Wisconsin",41.2,19,stable,37186,55,45,41.2,58.6
WI,"Green Lake County, Wisconsin",2274,1143,1131,55047,46780,47180,40500,45357,46875,31293,8270,1201,8267,1029,16537,2230,"Green Lake County, Wisconsin(6,10)",53.7,15,"Green Lake County, Wisconsin",40.7,12,stable,18856,55,47,40.7,53.7
WI,"Iowa County, Wisconsin",2448,1154,1294,55049,55188,55340,NA,NA,NA,40972,10926,886,11228,549,22154,1435,"Iowa County, Wisconsin(6,10)",56,17,"Iowa County, Wisconsin",37.2,11,stable,23813,55,49,37.2,56
WI,"Iron County, Wisconsin",653,277,376,55051,42543,42818,NA,NA,NA,45833,2598,286,2655,263,5253,549,"Iron County, Wisconsin(6,10)",79.3,9,"Iron County, Wisconsin",50.5,6,stable,5794,55,51,50.5,79.3
WI,"Jackson County, Wisconsin",2810,1234,1576,55053,47851,48354,NA,42027,99531,42083,8752,1133,8570,882,17322,2015,"Jackson County, Wisconsin(6,10)",69,19,"Jackson County, Wisconsin",50.7,14,falling,20554,55,53,50.7,69
WI,"Jefferson County, Wisconsin",8597,3917,4680,55055,56877,57634,44167,NA,30375,45387,38604,3136,39813,2311,78417,5447,"Jefferson County, Wisconsin(6,10)",56.2,52,"Jefferson County, Wisconsin",38.7,36,stable,84559,55,55,38.7,56.2
WI,"Juneau County, Wisconsin",3567,1754,1813,55057,44961,45367,38750,36750,26781,43688,11261,1407,11465,855,22726,2262,"Juneau County, Wisconsin(6,10)",67.5,26,"Juneau County, Wisconsin",54.7,21,falling,26224,55,57,54.7,67.5
WI,"Kenosha County, Wisconsin",24823,11271,13552,55059,54918,56894,27112,34063,62409,36858,72812,8862,77613,6584,150425,15446,"Kenosha County, Wisconsin(6,10)",73.1,120,"Kenosha County, Wisconsin",52.7,87,stable,168437,55,59,52.7,73.1
WI,"Kewaunee County, Wisconsin",1800,762,1038,55061,56863,56975,NA,NA,NA,55938,9778,576,9635,354,19413,930,"Kewaunee County, Wisconsin(6,10)",50.7,14,"Kewaunee County, Wisconsin",33.2,9,stable,20366,55,61,33.2,50.7
WI,"La Crosse County, Wisconsin",16616,7106,9510,55063,50539,51020,30278,37885,49523,30972,52456,4225,55751,3356,108207,7581,"La Crosse County, Wisconsin(6,10)",60.4,77,"La Crosse County, Wisconsin",43.1,55,falling,118212,55,63,43.1,60.4
WI,"Lafayette County, Wisconsin",1800,809,991,55065,51445,51575,NA,57857,NA,45625,7492,966,7453,824,14945,1790,"Lafayette County, Wisconsin(6,10)",47.5,11,"Lafayette County, Wisconsin",35.5,8,stable,16829,55,65,35.5,47.5
WI,"Langlade County, Wisconsin",3063,1523,1540,55067,41775,42162,NA,18947,NA,25708,8727,909,8809,860,17536,1769,"Langlade County, Wisconsin(6,10)",64.2,20,"Langlade County, Wisconsin",50.4,16,stable,19223,55,67,50.4,64.2
WI,"Lincoln County, Wisconsin",2800,1249,1551,55069,49721,49544,NA,44167,NA,NA,12683,1144,13038,864,25721,2008,"Lincoln County, Wisconsin(6,10)",64.1,27,"Lincoln County, Wisconsin",47.4,20,stable,27980,55,69,47.4,64.1
WI,"Manitowoc County, Wisconsin",7957,3304,4653,55071,48398,48451,NA,51000,41786,34167,37344,2605,38095,1898,75439,4503,"Manitowoc County, Wisconsin(6,10)",52.2,59,"Manitowoc County, Wisconsin",38.4,44,stable,79806,55,71,38.4,52.2
WI,"Marathon County, Wisconsin",14095,6537,7558,55073,54083,54669,40750,27292,50731,32316,61200,6094,62787,3920,123987,10014,"Marathon County, Wisconsin(6,10)",48.8,78,"Marathon County, Wisconsin",37.7,61,stable,135868,55,73,37.7,48.8
WI,"Marinette County, Wisconsin",5168,2229,2939,55075,43425,43383,78472,36250,250001,42500,18931,1561,19019,1227,37950,2788,"Marinette County, Wisconsin(6,10)",72.3,47,"Marinette County, Wisconsin",50.2,33,stable,40884,55,75,50.2,72.3
WI,"Marquette County, Wisconsin",2069,994,1075,55077,46242,46266,NA,56250,NA,37813,6877,704,6849,551,13726,1255,"Marquette County, Wisconsin(6,10)",76.3,19,"Marquette County, Wisconsin",59.2,15,stable,15075,55,77,59.2,76.3
WI,"Menominee County, Wisconsin",1535,735,800,55078,35343,50662,NA,32375,36667,NA,1427,716,1653,602,3080,1318,"Menominee County, Wisconsin(6,10)",80.9,4,"Menominee County, Wisconsin",*,*,**,4573,55,78,NA,80.9
WI,"Milwaukee County, Wisconsin",201124,91053,110071,55079,43873,53056,26853,32240,51879,34006,396071,59798,448635,42222,844706,102020,"Milwaukee County, Wisconsin(6,10)",71.1,658,"Milwaukee County, Wisconsin",52,484,falling,957735,55,79,52,71.1
WI,"Monroe County, Wisconsin",6676,3011,3665,55081,50694,51116,NA,47813,NA,56667,19450,2657,20110,2060,39560,4717,"Monroe County, Wisconsin(6,10)",77.3,41,"Monroe County, Wisconsin",52.2,28,stable,45549,55,81,52.2,77.3
WI,"Oconto County, Wisconsin",3466,1682,1784,55083,52765,53174,NA,52344,NA,28882,17497,1497,17166,1051,34663,2548,"Oconto County, Wisconsin(6,10)",76.5,39,"Oconto County, Wisconsin",47.2,24,stable,37435,55,83,47.2,76.5
WI,"Oneida County, Wisconsin",3632,1646,1986,55085,46516,46718,NA,27782,48750,55583,16064,1601,16488,970,32552,2571,"Oneida County, Wisconsin(6,10)",78.2,48,"Oneida County, Wisconsin",53.2,33,stable,35567,55,85,53.2,78.2
WI,"Outagamie County, Wisconsin",15723,7230,8493,55087,58765,59824,40673,54397,55625,38773,82663,6476,85176,4627,167839,11103,"Outagamie County, Wisconsin(6,10)",54.8,99,"Outagamie County, Wisconsin",39.6,72,falling,183245,55,87,39.6,54.8
WI,"Ozaukee County, Wisconsin",4467,1716,2751,55089,76433,75758,82070,NA,127457,56607,40545,2024,42586,1561,83131,3585,"Ozaukee County, Wisconsin(6,10)",49.4,55,"Ozaukee County, Wisconsin",32.5,37,falling,87850,55,89,32.5,49.4
WI,"Pepin County, Wisconsin",947,403,544,55091,49516,49677,NA,NA,NA,14500,3293,370,3209,382,6502,752,"Pepin County, Wisconsin(6,10)",53.4,6,"Pepin County, Wisconsin",38.1,4,stable,7290,55,91,38.1,53.4
WI,"Pierce County, Wisconsin",4615,2047,2568,55093,61611,62298,NA,NA,NA,63947,18519,1653,19153,1225,37672,2878,"Pierce County, Wisconsin(6,10)",37.6,15,"Pierce County, Wisconsin",36.7,14,stable,40889,55,93,36.7,37.6
WI,"Polk County, Wisconsin",4407,1978,2429,55095,50714,50912,30096,39107,33542,50417,19563,2138,19648,1782,39211,3920,"Polk County, Wisconsin(6,10)",52.3,31,"Polk County, Wisconsin",44.7,27,stable,43441,55,95,44.7,52.3
WI,"Portage County, Wisconsin",10095,5009,5086,55097,51613,52562,NA,NA,24479,24375,32286,2817,33287,1724,65573,4541,"Portage County, Wisconsin(6,10)",54.3,42,"Portage County, Wisconsin",38.6,30,stable,70408,55,97,38.6,54.3
WI,"Price County, Wisconsin",1860,888,972,55099,43137,43083,NA,22813,NA,27031,6398,455,6296,455,12694,910,"Price County, Wisconsin(6,10)",58,14,"Price County, Wisconsin",47,11,stable,13645,55,99,47,58
WI,"Racine County, Wisconsin",23768,9979,13789,55101,55584,60923,26552,57045,52326,36852,83220,10012,89921,7615,173141,17627,"Racine County, Wisconsin(6,10)",69.5,153,"Racine County, Wisconsin",47.5,104,stable,195080,55,101,47.5,69.5
WI,"Richland County, Wisconsin",2609,1271,1338,55103,44810,45092,NA,2499,NA,18611,7966,906,8038,695,16004,1601,"Richland County, Wisconsin(6,10)",57.7,14,"Richland County, Wisconsin",43.6,11,stable,17495,55,103,43.6,57.7
WI,"Rock County, Wisconsin",23498,10753,12745,55105,50324,51736,22852,25809,71917,34851,69942,8250,75101,6048,145043,14298,"Rock County, Wisconsin(6,10)",74.9,139,"Rock County, Wisconsin",54.5,101,stable,161448,55,105,54.5,74.9
WI,"Rusk County, Wisconsin",2252,1121,1131,55107,39194,39069,NA,18438,46563,60208,6262,886,6450,621,12712,1507,"Rusk County, Wisconsin(6,10)",76,18,"Rusk County, Wisconsin",55.7,13,stable,14124,55,107,55.7,76
WI,"St. Croix County, Wisconsin",5502,2468,3034,55109,70886,71315,25817,22237,79688,44219,39513,2938,40514,2392,80027,5330,"St. Croix County, Wisconsin(6,10)",45.4,35,"St. Croix County, Wisconsin",37.9,29,falling,87513,55,109,37.9,45.4
WI,"Sauk County, Wisconsin",7656,3355,4301,55111,51055,51580,16728,40156,NA,45965,28199,2991,28541,2533,56740,5524,"Sauk County, Wisconsin(6,10)",57.3,44,"Sauk County, Wisconsin",50,39,stable,63642,55,111,50,57.3
WI,"Sawyer County, Wisconsin",2673,1195,1478,55113,41665,44169,23750,30773,25625,36964,7117,1018,7312,728,14429,1746,"Sawyer County, Wisconsin(6,10)",67.3,18,"Sawyer County, Wisconsin",54.9,15,falling,16376,55,113,54.9,67.3
WI,"Shawano County, Wisconsin",4451,1998,2453,55115,47861,48485,11250,40313,53125,32500,18453,2016,18780,1709,37233,3725,"Shawano County, Wisconsin(6,10)",55,33,"Shawano County, Wisconsin",44.9,27,stable,41304,55,115,44.9,55
WI,"Sheboygan County, Wisconsin",10348,4731,5617,55117,53713,53853,27042,50938,55183,44219,51687,4580,53467,3184,105154,7764,"Sheboygan County, Wisconsin(6,10)",60.6,84,"Sheboygan County, Wisconsin",45.2,63,stable,115569,55,117,45.2,60.6
WI,"Taylor County, Wisconsin",2527,1150,1377,55119,45420,45509,NA,NA,NA,40921,9110,1300,9115,813,18225,2113,"Taylor County, Wisconsin(6,10)",47.4,13,"Taylor County, Wisconsin",29.4,8,stable,20455,55,119,29.4,47.4
WI,"Trempealeau County, Wisconsin",3078,1355,1723,55121,51077,52104,NA,NA,NA,40536,13246,1379,13470,889,26716,2268,"Trempealeau County, Wisconsin(6,10)",57.9,21,"Trempealeau County, Wisconsin",47.1,18,stable,29550,55,121,47.1,57.9
WI,"Vernon County, Wisconsin",4757,2125,2632,55123,47675,47927,NA,NA,NA,30938,12288,2659,12561,2463,24849,5122,"Vernon County, Wisconsin(6,10)",55,23,"Vernon County, Wisconsin",43.5,19,stable,30506,55,123,43.5,55
WI,"Vilas County, Wisconsin",3047,1365,1682,55125,41061,42373,NA,18950,NA,41974,9450,1164,9854,710,19304,1874,"Vilas County, Wisconsin(6,10)",66.9,28,"Vilas County, Wisconsin",48.1,21,stable,21387,55,125,48.1,66.9
WI,"Walworth County, Wisconsin",13499,5855,7644,55127,53445,54121,24583,NA,61250,44681,45658,5450,47291,3835,92949,9285,"Walworth County, Wisconsin(6,10)",64,75,"Walworth County, Wisconsin",46.2,54,stable,102804,55,127,46.2,64
WI,"Washburn County, Wisconsin",2022,911,1111,55129,42368,42741,25962,43750,61389,21500,6874,832,7253,554,14127,1386,"Washburn County, Wisconsin(6,10)",71.5,19,"Washburn County, Wisconsin",53.8,14,stable,15552,55,129,53.8,71.5
WI,"Washington County, Wisconsin",7375,2950,4425,55131,69237,69459,64933,112946,81713,50810,62004,3345,63727,2899,125731,6244,"Washington County, Wisconsin(6,10)",57.3,89,"Washington County, Wisconsin",39.5,61,stable,133674,55,131,39.5,57.3
WI,"Waukesha County, Wisconsin",20433,8852,11581,55133,76545,76593,31865,74091,114511,55123,182973,9129,191505,7700,374478,16829,"Waukesha County, Wisconsin(6,10)",54.6,262,"Waukesha County, Wisconsin",39.8,191,stable,396488,55,133,39.8,54.6
WI,"Waupaca County, Wisconsin",5232,2328,2904,55135,51994,52276,48839,46904,27250,32917,23435,2093,23613,1501,47048,3594,"Waupaca County, Wisconsin(6,10)",64.7,48,"Waupaca County, Wisconsin",50.4,38,stable,51945,55,135,50.4,64.7
WI,"Waushara County, Wisconsin",2385,1092,1293,55137,45166,45540,NA,NA,NA,43750,10355,1332,10471,1011,20826,2343,"Waushara County, Wisconsin(6,10)",72,28,"Waushara County, Wisconsin",50.7,20,stable,24033,55,137,50.7,72
WI,"Winnebago County, Wisconsin",19209,8291,10918,55139,52018,52567,26281,31573,52813,41099,74590,6032,78495,4794,153085,10826,"Winnebago County, Wisconsin(6,10)",62.2,117,"Winnebago County, Wisconsin",44.7,85,stable,169546,55,139,44.7,62.2
WI,"Wood County, Wisconsin",7996,3644,4352,55141,48961,48740,51660,31413,85527,34483,33602,2741,35148,1845,68750,4586,"Wood County, Wisconsin(6,10)",57.4,58,"Wood County, Wisconsin",40.3,42,stable,73435,55,141,40.3,57.4
WV,"Barbour County, West Virginia",3482,1682,1800,54001,37066,37197,NA,NA,NA,NA,6927,1173,7434,1040,14361,2213,"Barbour County, West Virginia(6,10)",58.8,13,"Barbour County, West Virginia",42.9,9,falling,16704,54,1,42.9,58.8
WV,"Berkeley County, West Virginia",15235,6801,8434,54003,55239,55898,49063,NA,105962,53707,47309,5793,49115,5848,96424,11641,"Berkeley County, West Virginia(6,10)",83.7,92,"Berkeley County, West Virginia",65.1,69,stable,111901,54,3,65.1,83.7
WV,"Boone County, West Virginia",5529,2643,2886,54005,39958,39991,26875,NA,77188,NA,10532,1330,10908,1114,21440,2444,"Boone County, West Virginia(6,10)",111.8,34,"Boone County, West Virginia",81.5,25,stable,23372,54,5,81.5,111.8
WV,"Braxton County, West Virginia",2941,1496,1445,54007,32750,33206,NA,NA,NA,NA,6032,961,6145,971,12177,1932,"Braxton County, West Virginia(6,10)",72.4,16,"Braxton County, West Virginia",61.4,13,stable,14415,54,7,61.4,72.4
WV,"Brooke County, West Virginia",2960,1290,1670,54009,46215,46196,NA,NA,NA,58594,10230,1236,11001,1006,21231,2242,"Brooke County, West Virginia(6,10)",64.7,24,"Brooke County, West Virginia",54.5,21,stable,23350,54,9,54.5,64.7
WV,"Cabell County, West Virginia",20110,8964,11146,54011,38344,39722,17396,23580,54766,34814,40407,5898,44087,5004,84494,10902,"Cabell County, West Virginia(6,10)",89.9,109,"Cabell County, West Virginia",64.3,79,stable,96844,54,11,64.3,89.9
WV,"Calhoun County, West Virginia",1314,569,745,54013,35568,36829,NA,NA,NA,61063,3209,567,3072,686,6281,1253,"Calhoun County, West Virginia(6,10)",90.9,11,"Calhoun County, West Virginia",79,9,stable,7470,54,13,79,90.9
WV,"Clay County, West Virginia",2530,1119,1411,54015,31325,30933,NA,NA,NA,NA,3955,603,4026,498,7981,1101,"Clay County, West Virginia(6,10)",99.8,13,"Clay County, West Virginia",70.6,9,stable,8910,54,15,70.6,99.8
WV,"Doddridge County, West Virginia",1190,457,733,54017,39974,40819,NA,NA,NA,NA,3243,662,3175,536,6418,1198,"Doddridge County, West Virginia(6,10)",40,4,"Doddridge County, West Virginia",52.3,6,stable,8176,54,17,52.3,40
WV,"Fayette County, West Virginia",8683,3956,4727,54019,36293,36475,33007,57895,NA,32188,18691,3142,19390,2986,38081,6128,"Fayette County, West Virginia(6,10)",87.6,56,"Fayette County, West Virginia",73.5,47,stable,44997,54,19,73.5,87.6
WV,"Gilmer County, West Virginia",1781,977,804,54021,37536,39438,NA,NA,NA,NA,3146,508,2909,501,6055,1009,"Gilmer County, West Virginia(6,10)",46.8,5,"Gilmer County, West Virginia",47.5,5,stable,8518,54,21,47.5,46.8
WV,"Grant County, West Virginia",1791,882,909,54023,39088,39098,NA,NA,NA,NA,5242,612,5419,432,10661,1044,"Grant County, West Virginia(6,10)",52.7,9,"Grant County, West Virginia",40.4,7,stable,11766,54,23,40.4,52.7
WV,"Greenbrier County, West Virginia",6530,2939,3591,54025,39746,40752,35523,NA,2499,34816,14842,2261,15908,2024,30750,4285,"Greenbrier County, West Virginia(6,10)",67.8,38,"Greenbrier County, West Virginia",48.6,26,falling,35516,54,25,48.6,67.8
WV,"Hampshire County, West Virginia",4721,2317,2404,54027,27995,28796,18271,NA,NA,NA,9515,2254,9704,1538,19219,3792,"Hampshire County, West Virginia(6,10)",83.8,27,"Hampshire County, West Virginia",63.5,20,stable,23353,54,27,63.5,83.8
WV,"Hancock County, West Virginia",4835,2034,2801,54029,39959,40000,24716,76354,NA,NA,13027,1533,13682,1731,26709,3264,"Hancock County, West Virginia(6,10)",78.9,36,"Hancock County, West Virginia",62.4,29,stable,29815,54,29,62.4,78.9
WV,"Hardy County, West Virginia",1863,773,1090,54031,40303,41394,33973,NA,18065,21103,6160,846,6168,704,12328,1550,"Hardy County, West Virginia(6,10)",68.8,13,"Hardy County, West Virginia",39.4,8,stable,13852,54,31,39.4,68.8
WV,"Harrison County, West Virginia",11072,4992,6080,54033,43987,44182,33229,NA,NA,41809,29328,4163,31103,3815,60431,7978,"Harrison County, West Virginia(6,10)",87.3,82,"Harrison County, West Virginia",61.5,58,falling,68714,54,33,61.5,87.3
WV,"Jackson County, West Virginia",4743,2268,2475,54035,41314,41576,NA,NA,NA,NA,13027,1410,13302,1341,26329,2751,"Jackson County, West Virginia(6,10)",74.3,31,"Jackson County, West Virginia",63.7,26,stable,29237,54,35,63.7,74.3
WV,"Jefferson County, West Virginia",6222,2521,3701,54037,66677,66801,70478,NA,NA,65682,23866,3089,25503,2490,49369,5579,"Jefferson County, West Virginia(6,10)",71,41,"Jefferson County, West Virginia",51.6,30,falling,56482,54,37,51.6,71
WV,"Kanawha County, West Virginia",29703,13258,16445,54039,45882,46985,28913,25750,78125,55272,80160,10691,88818,9372,168978,20063,"Kanawha County, West Virginia(6,10)",87.3,231,"Kanawha County, West Virginia",64.5,170,falling,188332,54,39,64.5,87.3
WV,"Lewis County, West Virginia",3357,1583,1774,54041,37849,37854,NA,NA,48125,NA,7138,1004,7214,992,14352,1996,"Lewis County, West Virginia(6,10)",100.1,25,"Lewis County, West Virginia",64.6,15,stable,16448,54,41,64.6,100.1
WV,"Lincoln County, West Virginia",5870,2758,3112,54043,35800,35870,NA,NA,NA,NA,9453,1235,9667,1145,19120,2380,"Lincoln County, West Virginia(6,10)",111.5,32,"Lincoln County, West Virginia",77.3,22,stable,21415,54,43,77.3,111.5
WV,"Logan County, West Virginia",6902,2915,3987,54045,36763,36929,NA,NA,NA,37050,14693,2538,15770,2187,30463,4725,"Logan County, West Virginia(6,10)",115.7,56,"Logan County, West Virginia",95.1,45,falling,34707,54,45,95.1,115.7
WV,"McDowell County, West Virginia",6943,3196,3747,54047,24921,25338,21730,NA,NA,NA,7748,1595,8604,1653,16352,3248,"McDowell County, West Virginia(6,10)",103.9,32,"McDowell County, West Virginia",86.6,26,stable,19835,54,47,86.6,103.9
WV,"Marion County, West Virginia",8980,4005,4975,54049,43165,44479,23850,NA,43750,76250,24474,3170,25607,3172,50081,6342,"Marion County, West Virginia(6,10)",77.5,61,"Marion County, West Virginia",60.7,46,stable,56925,54,49,60.7,77.5
WV,"Marshall County, West Virginia",4128,1676,2452,54051,45182,45314,NA,NA,NA,33250,13971,1738,14765,1607,28736,3345,"Marshall County, West Virginia(6,10)",72.8,34,"Marshall County, West Virginia",50.4,24,falling,31978,54,51,50.4,72.8
WV,"Mason County, West Virginia",5075,2409,2666,54053,36448,36003,NA,NA,NA,NA,11796,1296,12095,1313,23891,2609,"Mason County, West Virginia(6,10)",87.6,34,"Mason County, West Virginia",74.4,28,stable,27037,54,53,74.4,87.6
WV,"Mercer County, West Virginia",13236,5322,7914,54055,36195,37035,22448,18971,NA,NA,25765,3623,28569,3502,54334,7125,"Mercer County, West Virginia(6,10)",84,75,"Mercer County, West Virginia",65.2,59,stable,61164,54,55,65.2,84
WV,"Mineral County, West Virginia",4562,2071,2491,54057,31790,32371,9276,NA,231544,NA,11880,1750,11854,2065,23734,3815,"Mineral County, West Virginia(6,10)",82.3,32,"Mineral County, West Virginia",65.2,26,stable,27451,54,57,65.2,82.3
WV,"Mingo County, West Virginia",6654,2873,3781,54059,33221,33791,24730,NA,NA,NA,11009,1662,11547,1629,22556,3291,"Mingo County, West Virginia(6,10)",106.5,35,"Mingo County, West Virginia",83.1,27,stable,25292,54,59,83.1,106.5
WV,"Monongalia County, West Virginia",20923,10509,10414,54061,45467,46312,26667,NA,52232,21985,46145,5157,44376,4373,90521,9530,"Monongalia County, West Virginia(6,10)",65.9,56,"Monongalia County, West Virginia",43.2,36,falling,104236,54,61,43.2,65.9
WV,"Monroe County, West Virginia",2252,894,1358,54063,36918,37511,15590,NA,NA,41270,5882,761,5852,912,11734,1673,"Monroe County, West Virginia(6,10)",63.3,13,"Monroe County, West Virginia",46,10,stable,13506,54,63,46,63.3
WV,"Morgan County, West Virginia",2218,879,1339,54065,39324,38936,NA,NA,124219,46354,7057,1471,7458,1323,14515,2794,"Morgan County, West Virginia(6,10)",68.9,18,"Morgan County, West Virginia",57.9,15,stable,17524,54,65,57.9,68.9
WV,"Nicholas County, West Virginia",4636,2006,2630,54067,39171,39134,NA,NA,NA,NA,11361,1372,11541,1512,22902,2884,"Nicholas County, West Virginia(6,10)",67.5,25,"Nicholas County, West Virginia",66.3,25,stable,25594,54,67,66.3,67.5
WV,"Ohio County, West Virginia",6658,2958,3700,54069,40569,41507,21202,NA,50750,NA,18578,2150,20274,2075,38852,4225,"Ohio County, West Virginia(6,10)",73.5,47,"Ohio County, West Virginia",52.8,35,stable,43066,54,69,52.8,73.5
WV,"Pendleton County, West Virginia",1500,776,724,54071,36953,37000,NA,NA,NA,NA,3204,399,3191,435,6395,834,"Pendleton County, West Virginia(6,10)",44.2,6,"Pendleton County, West Virginia",35.6,5,stable,7229,54,71,35.6,44.2
WV,"Pleasants County, West Virginia",1260,616,644,54073,44288,44919,NA,NA,NA,NA,3159,334,3257,266,6416,600,"Pleasants County, West Virginia(6,10)",98.3,10,"Pleasants County, West Virginia",75.6,8,stable,7674,54,73,75.6,98.3
WV,"Pocahontas County, West Virginia",1382,568,814,54075,36827,37415,NA,NA,NA,NA,3544,655,3740,453,7284,1108,"Pocahontas County, West Virginia(6,10)",78.2,11,"Pocahontas County, West Virginia",55.9,8,stable,8607,54,75,55.9,78.2
WV,"Preston County, West Virginia",4574,2002,2572,54077,45064,45167,NA,48125,NA,50729,13622,2010,14136,1716,27758,3726,"Preston County, West Virginia(6,10)",68.1,31,"Preston County, West Virginia",45.8,20,stable,33940,54,77,45.8,68.1
WV,"Putnam County, West Virginia",5494,2026,3468,54079,56774,57218,NA,NA,NA,61034,25264,2324,26190,2483,51454,4807,"Putnam County, West Virginia(6,10)",76.1,52,"Putnam County, West Virginia",48,33,falling,56848,54,79,48,76.1
WV,"Raleigh County, West Virginia",13322,5897,7425,54081,41032,42058,23850,68547,56058,NA,32067,4667,34436,4328,66503,8995,"Raleigh County, West Virginia(6,10)",81,86,"Raleigh County, West Virginia",59.8,64,stable,77510,54,81,59.8,81
WV,"Randolph County, West Virginia",4610,1968,2642,54083,39457,39283,NA,NA,NA,9500,11948,1779,12104,1717,24052,3496,"Randolph County, West Virginia(6,10)",63.3,27,"Randolph County, West Virginia",50.7,20,stable,29126,54,83,50.7,63.3
WV,"Ritchie County, West Virginia",2071,995,1076,54085,37636,38091,NA,NA,NA,NA,4232,754,4496,591,8728,1345,"Ritchie County, West Virginia(6,10)",105.7,16,"Ritchie County, West Virginia",81.5,12,stable,9982,54,85,81.5,105.7
WV,"Roane County, West Virginia",3165,1382,1783,54087,31813,31854,NA,35625,62500,22778,6351,829,6571,791,12922,1620,"Roane County, West Virginia(6,10)",76.5,16,"Roane County, West Virginia",65.2,14,stable,14435,54,87,65.2,76.5
WV,"Summers County, West Virginia",2184,1100,1084,54089,36651,37903,29222,NA,NA,NA,5359,752,5793,539,11152,1291,"Summers County, West Virginia(6,10)",54.1,11,"Summers County, West Virginia",36.5,8,falling,13239,54,89,36.5,54.1
WV,"Taylor County, West Virginia",2731,1296,1435,54091,43970,44576,35234,NA,NA,NA,7287,967,7477,801,14764,1768,"Taylor County, West Virginia(6,10)",72.2,17,"Taylor County, West Virginia",68.5,15,stable,16912,54,91,68.5,72.2
WV,"Tucker County, West Virginia",1013,450,563,54093,40533,40922,NA,NA,NA,NA,3067,301,3069,363,6136,664,"Tucker County, West Virginia(6,10)",75.3,9,"Tucker County, West Virginia",49.7,6,stable,6966,54,93,49.7,75.3
WV,"Tyler County, West Virginia",1765,675,1090,54095,38854,39149,NA,NA,NA,NA,3826,615,3884,634,7710,1249,"Tyler County, West Virginia(6,10)",81,11,"Tyler County, West Virginia",64,9,stable,8975,54,95,64,81
WV,"Upshur County, West Virginia",4189,1928,2261,54097,40330,40803,NA,NA,NA,NA,10452,1736,10744,1471,21196,3207,"Upshur County, West Virginia(6,10)",74,24,"Upshur County, West Virginia",59.9,19,stable,24758,54,97,59.9,74
WV,"Wayne County, West Virginia",8468,3971,4497,54099,36318,36313,NA,NA,246300,72571,17510,2711,18273,2887,35783,5598,"Wayne County, West Virginia(6,10)",89.5,51,"Wayne County, West Virginia",64.2,36,falling,40971,54,99,64.2,89.5
WV,"Webster County, West Virginia",2307,1033,1274,54101,29086,29295,NA,NA,NA,NA,3713,652,3833,671,7546,1323,"Webster County, West Virginia(6,10)",94.6,13,"Webster County, West Virginia",81,10,stable,8755,54,101,81,94.6
WV,"Wetzel County, West Virginia",3169,1354,1815,54103,39096,39301,NA,NA,NA,NA,6968,930,7266,895,14234,1825,"Wetzel County, West Virginia(6,10)",87,22,"Wetzel County, West Virginia",71.2,18,stable,15816,54,103,71.2,87
WV,"Wirt County, West Virginia",792,291,501,54105,39352,38873,NA,NA,NA,NA,2685,251,2492,413,5177,664,"Wirt County, West Virginia(6,10)",78.8,7,"Wirt County, West Virginia",54.6,4,falling,5880,54,105,54.6,78.8
WV,"Wood County, West Virginia",14825,6309,8516,54107,41884,42134,31188,52742,NA,32500,36251,5402,40175,4243,76426,9645,"Wood County, West Virginia(6,10)",81.9,97,"Wood County, West Virginia",60.5,71,falling,86452,54,107,60.5,81.9
WV,"Wyoming County, West Virginia",4934,2320,2614,54109,33730,33828,NA,NA,NA,NA,9990,1311,10135,1352,20125,2663,"Wyoming County, West Virginia(6,10)",90.3,27,"Wyoming County, West Virginia",80,24,stable,22151,54,109,80,90.3
WY,"Albany County, Wyoming",9510,4748,4762,56001,42834,43768,NA,NA,21437,37286,17650,1926,16276,1516,33926,3442,"Albany County, Wyoming(6,10)",40.8,11,"Albany County, Wyoming",29.1,8,falling,37956,56,1,29.1,40.8
WY,"Big Horn County, Wyoming",1408,632,776,56003,51679,51894,NA,NA,47917,40000,4937,968,4867,900,9804,1868,"Big Horn County, Wyoming(6,10)",41.8,7,"Big Horn County, Wyoming",40.2,7,falling,12022,56,3,40.2,41.8
WY,"Campbell County, Wyoming",3412,1380,2032,56005,80060,81018,NA,70833,82750,60970,21583,3092,19806,3159,41389,6251,"Campbell County, Wyoming(6,10)",53.1,16,"Campbell County, Wyoming",60.1,16,stable,49220,56,5,60.1,53.1
WY,"Carbon County, Wyoming",2280,948,1332,56007,56825,58156,30923,110114,NA,43472,6819,1089,6058,996,12877,2085,"Carbon County, Wyoming(6,10)",58.4,10,"Carbon County, Wyoming",41.6,7,stable,15559,56,7,41.6,58.4
WY,"Converse County, Wyoming",1308,486,822,56009,62307,62073,NA,85391,NA,69615,6497,587,6052,902,12549,1489,"Converse County, Wyoming(6,10)",58.3,9,"Converse County, Wyoming",40.6,6,falling,14236,56,9,40.6,58.3
WY,"Crook County, Wyoming",362,206,156,56011,60445,60685,NA,NA,NA,35089,3201,479,3060,440,6261,919,"Crook County, Wyoming(6,10)",46.2,5,"Crook County, Wyoming",47.6,5,**,7444,56,11,47.6,46.2
WY,"Fremont County, Wyoming",5637,2586,3051,56013,52773,54942,32083,45569,39412,37596,15856,4060,16468,3762,32324,7822,"Fremont County, Wyoming(6,10)",45.7,22,"Fremont County, Wyoming",38.6,19,stable,40315,56,13,38.6,45.7
WY,"Goshen County, Wyoming",2261,1048,1213,56015,42689,44524,NA,40714,NA,40417,5672,964,5569,723,11241,1687,"Goshen County, Wyoming(6,10)",52.5,10,"Goshen County, Wyoming",40.5,8,stable,13383,56,15,40.5,52.5
WY,"Hot Springs County, Wyoming",500,140,360,56017,45278,45521,NA,NA,NA,NA,1942,395,2048,319,3990,714,"Hot Springs County, Wyoming(6,10)",75.8,7,"Hot Springs County, Wyoming",50.3,4,stable,4741,56,17,50.3,75.8
WY,"Johnson County, Wyoming",534,294,240,56019,54065,53975,NA,NA,NA,NA,4058,449,3660,379,7718,828,"Johnson County, Wyoming(6,10)",38.2,5,"Johnson County, Wyoming",29.9,4,stable,8585,56,19,29.9,38.2
WY,"Laramie County, Wyoming",9369,3777,5592,56021,60706,63653,48929,NA,NA,42148,40089,5563,41797,4991,81886,10554,"Laramie County, Wyoming(6,10)",52.1,53,"Laramie County, Wyoming",42.3,42,stable,97121,56,21,42.3,52.1
WY,"Lincoln County, Wyoming",1435,662,773,56023,66647,66896,NA,55750,38958,39258,8316,1002,7928,941,16244,1943,"Lincoln County, Wyoming(6,10)",32.1,7,"Lincoln County, Wyoming",26.8,5,stable,18722,56,23,26.8,32.1
WY,"Natrona County, Wyoming",8407,3605,4802,56025,56871,58367,24891,41949,NA,40732,33677,6119,33595,5518,67272,11637,"Natrona County, Wyoming(6,10)",58.2,48,"Natrona County, Wyoming",41.5,35,falling,82178,56,25,41.5,58.2
WY,"Niobrara County, Wyoming",328,154,174,56027,40398,40739,NA,NA,NA,NA,1011,142,931,148,1942,290,"Niobrara County, Wyoming(6,10)",*,3 or fewer,"Niobrara County, Wyoming",*,*,**,2542,56,27,NA,NA
WY,"Park County, Wyoming",2024,492,1532,56029,56363,56992,35653,51000,NA,50625,12141,1955,12766,1857,24907,3812,"Park County, Wyoming(6,10)",36.3,15,"Park County, Wyoming",34.2,14,stable,29228,56,29,34.2,36.3
WY,"Platte County, Wyoming",1391,562,829,56031,38500,40133,NA,NA,NA,17946,3579,837,3622,602,7201,1439,"Platte County, Wyoming(6,10)",52,7,"Platte County, Wyoming",40,6,stable,8812,56,31,40,52
WY,"Sheridan County, Wyoming",2381,1210,1171,56033,55455,56134,NA,60461,NA,48021,12684,1703,13415,1471,26099,3174,"Sheridan County, Wyoming(6,10)",52,20,"Sheridan County, Wyoming",42,15,stable,30009,56,33,42,52
WY,"Sublette County, Wyoming",812,453,359,56035,81772,79590,NA,NA,NA,127586,4509,822,4067,697,8576,1519,"Sublette County, Wyoming(6,10)",*,3 or fewer,"Sublette County, Wyoming",*,*,**,9899,56,35,NA,NA
WY,"Sweetwater County, Wyoming",5058,2177,2881,56037,69022,69333,23535,NA,NA,53175,19891,3318,18600,2683,38491,6001,"Sweetwater County, Wyoming(6,10)",39.9,14,"Sweetwater County, Wyoming",28.4,9,falling,44626,56,37,28.4,39.9
WY,"Teton County, Wyoming",1638,1026,612,56039,75325,77651,NA,NA,NA,41619,8948,2558,9555,1192,18503,3750,"Teton County, Wyoming(6,10)",23.7,5,"Teton County, Wyoming",29.1,5,stable,23125,56,39,29.1,23.7
WY,"Uinta County, Wyoming",2845,1453,1392,56041,56569,56532,NA,NA,NA,40194,9132,1413,8711,1503,17843,2916,"Uinta County, Wyoming(6,10)",31.7,6,"Uinta County, Wyoming",22.1,4,stable,20822,56,41,22.1,31.7
WY,"Washakie County, Wyoming",1137,489,648,56043,47652,48110,NA,NA,NA,29740,3349,691,3490,703,6839,1394,"Washakie County, Wyoming(6,10)",50,6,"Washakie County, Wyoming",38.2,5,stable,8328,56,43,38.2,50
WY,"Weston County, Wyoming",958,354,604,56045,57738,57842,NA,NA,NA,31875,2927,454,3087,314,6014,768,"Weston County, Wyoming(6,10)",44.9,4,"Weston County, Wyoming",43.5,4,stable,7234,56,45,43.5,44.9
